2.1073220249535813,4.018470545313468,2.9027043962997614,1.926135871064067,22,6,38,61,159,23
2.12861054256536,4.28444671938124,2.6260240472312417,1.5145485977317554,22,7,41,63,167,22
2.2517669201960646,4.268087267193728,2.553661616200788,1.755260710945317,23,6,27,61,169,34
2.4012584091871743,4.41417868136311,2.8360620822721843,1.753497569320701,19,7,32,65,171,33
1.5086090391148133,4.1881411449146615,2.2049670875613367,1.380900532304209,21,6,18,62,168,44
2.2860836303310674,4.166728648988821,2.9204923025915286,1.8829443398034282,15,7,40,63,155,23
1.8134535168432901,3.6806681535522827,2.4299551606293264,1.3587395776770845,21,7,40,63,154,23
1.657034798993366,3.3519241070066337,2.405960479536072,1.2805400592060856,17,6,44,60,152,16
1.4284095807592594,3.315584800344922,1.9393727453570941,1.1188010074815644,23,7,17,61,158,44
1.7619026815013217,3.5840458990923607,2.2431574908367966,1.2433373159355892,19,6,8,66,157,58
2.1764801401144256,4.143217166392081,2.7327181412541925,2.048401470152709,16,7,37,63,156,26
1.8947885978339514,3.883720947188011,2.402304542150054,1.5636926368483035,23,6,25,60,162,35
1.9083863129009244,4.10374818830507,2.691800820832146,1.5940951107127543,20,6,14,65,155,51
1.917521854806679,3.715364101718371,2.5134689450480607,1.2608117192845945,20,6,20,65,154,45
1.5968674586833194,3.3284575120559508,2.35644668862699,1.3581968983846289,20,7,16,62,153,46
1.7351581715206672,3.4603326026695758,2.3058797129029296,1.4028136528001494,23,6,40,63,159,23
1.7967694852249718,3.520939987821564,2.283901418356277,1.3820072708734756,23,6,20,60,156,40
2.032792831306852,3.496729425711846,2.614375544414425,1.6230352380072008,22,7,24,64,154,40
1.77175041145049,3.8477419443901946,2.407693732182136,1.5272867995720216,21,6,10,65,158,55
1.9324336728394798,3.8744243817205413,2.52399157267491,1.2219982577425594,23,7,10,59,152,49
1.9950973433218135,3.6890094307015193,2.4574521889201533,1.466190375467852,22,7,37,61,148,24
1.9723363760602517,3.6112504912917656,2.455384125083107,1.3665223838915026,19,7,28,63,151,35
2.0359190332099555,3.9253029466566507,2.7353151750245575,1.3309278469263075,22,7,19,61,148,42
1.6710785390937486,3.8014702892449312,1.9908550217772363,1.2906518684269412,22,7,18,62,153,44
2.1970669188996443,3.9031884584039958,2.6549107555670006,1.8783557525960828,17,7,35,63,143,28
0.5764028039102682,3.5717834858094224,1.9187699473881903,0.5459999313754715,26,7,10,66,147,56
1.9409114869371378,3.475543406725703,2.2821299358367666,1.4089519578602876,25,7,20,65,144,45
1.755134818494169,3.4833763656999563,2.348116517831716,1.3959852952214074,20,7,15,66,150,51
1.5701585059951524,3.346079897553743,2.5454496699595355,1.2962874256635932,22,7,22,59,148,37
1.915448636227852,3.716147354098012,2.5398628711315654,1.4818034699068603,21,6,32,61,150,29
1.8513024548822077,3.5660396040247866,2.518993801229607,1.4789948782594888,23,6,19,63,149,44
1.85267149825704,3.411715227037347,2.4142885273399193,1.4330766282655825,22,7,16,63,148,47
1.6920138185343188,3.1998171294864264,2.1538968844996234,1.3301878333066708,21,7,38,64,150,26
2.0498358338950338,3.47625913849481,2.577734042584729,1.6803521184368901,20,7,17,59,149,42
1.8583876693293107,3.880049827481156,2.449601713839254,1.4910087977215851,21,7,18,60,143,42
1.8754133454293984,4.158772896039027,2.488534497579927,1.5504592983623866,23,6,27,59,137,32
2.1091852455378013,3.8909902615180036,2.612034454351135,1.6375229654680044,21,6,33,60,136,27
1.737838895027959,3.2268196580522623,2.2622137051759137,1.2533847770681161,15,5,16,65,135,49
1.8878539694721854,3.5087723281428955,2.410879747338064,1.3913207925766422,22,7,11,60,136,49
1.8877773466384404,3.419813915429182,2.456822515997288,1.3488477710948932,17,7,37,60,136,23
1.9485307386016606,3.654503941523985,2.383000609635465,1.2280373652497985,20,7,27,61,142,34
2.113317980884262,4.050215463848835,2.870962108114355,1.5345178998074187,17,7,36,60,141,24
1.620896059729993,3.754490926057869,2.324691731892492,1.4005659852662085,19,7,17,64,145,47
1.9061603255351933,3.578335070871657,2.3682864120075355,1.5271977211684784,21,7,13,61,144,48
1.7668684599544116,3.335819964259345,2.254696203383296,1.2020199544103105,19,7,15,60,142,45
1.6879328211421858,3.156015589200041,2.1944827411626036,1.1496194964709456,19,6,11,64,146,53
1.7988843354044515,3.542141087319491,2.3062839613966015,1.3107884342398128,21,7,20,62,149,42
1.933003851608794,3.2256736234576824,2.3448996107333873,1.537901763561585,21,6,40,61,159,21
2.0069977842157645,3.8906556534356316,2.4376721002808432,1.5129785158721174,22,7,29,61,156,32
2.2043047878997886,3.941817860202733,3.0293905937266223,1.8038701292261317,21,6,24,63,152,39
2.0079324977167983,4.1474355422736675,2.61271554252974,1.7459096487542318,20,6,39,66,152,27
1.9139274870560121,3.8088108039730537,2.555840406971829,1.3014814297868993,20,7,17,62,140,45
2.0069381475199313,3.462533643387416,2.446883643821763,1.4717691268169077,16,6,32,61,137,29
2.0063426754700675,3.4578915234531427,2.547441080128414,1.6056679609262847,21,6,43,62,140,19
1.5866726945548897,3.35450876816317,2.4790628899143448,0.945145443291538,18,7,17,61,139,44
2.289575434628539,3.6626260344542523,2.682712517537227,1.6957858828736516,19,7,44,68,143,24
1.8663012767547238,3.7904121445237995,2.2579761504423126,1.1669103092931143,20,6,39,63,146,24
2.1672689604662825,4.147545586773761,2.6129290696439638,1.4477902862213021,17,6,40,65,149,25
0.9022498930402274,3.3584030369316804,2.001678773517381,1.326158459352992,54,7,9,29,139,20
1.6529209493401371,3.4240754862595395,2.1680745659846923,0.9948747894223118,50,7,9,64,144,55
1.6061009734892622,3.3750770716016136,2.518879494605534,1.683862557477139,19,7,11,60,146,49
1.2592358951454172,3.0966900614855186,2.414986415160308,1.2254057971145889,48,6,45,67,152,22
1.672494981159537,3.620946810726165,3.0789727381101875,1.3647303553545367,18,6,21,65,152,44
1.7507352487347907,3.3930493049536175,2.075768822106348,1.085225173062592,18,6,12,62,143,50
2.016790059100596,3.407906061642101,2.7020910320217766,1.5680827564776656,19,6,38,60,144,22
2.5115199950482463,3.6855447786738256,3.0020401540110138,2.5855710961899048,17,8,41,58,146,17
1.3997337959109202,3.4442377236085946,2.4552971093051177,1.2128340918239204,50,7,29,59,148,30
1.7007986607273327,3.439983554795804,2.5598832344258335,1.3345563009876207,24,7,17,61,149,44
1.8073177711508595,3.6942289973314733,2.265868561352003,1.5501635291253069,22,7,7,61,145,54
1.9160571332843317,3.4845409608257856,2.5634905699318455,1.5696340497426902,19,6,33,64,143,31
2.7120113411481457,4.040253461287227,3.32406640032975,2.0853446661141124,19,7,32,62,141,30
1.8230535735002467,3.28507930739759,2.2568104572421706,1.3547382348711192,20,7,12,30,141,18
1.633462240309017,3.263939134178913,2.367222073213077,1.3248347141793153,23,6,22,62,138,40
1.88847041725667,3.4684944319348348,2.394091035128971,1.3050487913634967,20,7,23,63,139,40
1.9010111835515966,3.5453370589788418,2.341601907739642,1.287724845302879,19,7,29,65,150,36
1.9197958977734744,3.7827729060334687,2.2243410612644348,1.308612612590435,18,6,18,59,147,41
1.7151321614535882,3.643795971849986,2.2833403806942516,1.2805577034185747,22,6,25,62,154,37
1.8625457376491281,3.7317815751593004,2.49503686975207,1.4973609031808062,23,7,20,58,148,38
1.7487171860878434,3.976240042950489,2.5626802410023686,1.6605928113561053,22,7,9,59,150,50
1.9678300852268844,3.8179618039769343,2.639194230099146,1.4626673516072415,18,6,32,59,145,27
2.0165687056587096,3.9034131447853473,2.5288279209177063,1.5862440016372008,21,6,31,63,145,32
1.7363739268928946,3.504422208082004,2.38413649140643,1.09272809250491,18,6,16,63,144,47
1.8164435968919759,3.3783127844517096,2.3757938425477128,1.2521485236720713,24,7,18,63,142,45
1.9528190415413549,3.5253540407671187,2.401882437403456,1.60305452981846,18,6,18,64,143,46
1.8199612855288034,3.550381228540364,2.7042912200973435,1.4239145358146543,17,7,29,58,144,29
1.7093547054983247,3.3887904670611033,2.3049296967874966,1.4798171371657143,23,7,8,59,139,51
2.0483171157894176,4.150445423060939,2.5532952279986567,1.703091252004015,20,6,23,61,142,38
1.8681477351383826,3.9123443565350815,2.503677826198972,1.5549781373023535,17,7,19,59,133,40
1.8644401108702573,3.61581359761623,2.3618549215579514,1.4350883912376746,15,6,15,67,137,52
1.8057469030757711,3.0367922487708467,2.443983178256219,1.3602012440310307,15,7,21,64,137,43
1.781305871186492,3.0205444301942053,2.281022606909752,1.319719593608621,19,7,13,62,136,49
1.6650688858569307,3.1845654354883144,2.0802589230642017,1.2387476209000214,20,7,16,61,143,45
1.7646230409938077,3.437020535788403,2.2102978931365724,1.2921507814415922,21,7,37,61,143,24
1.638156499174718,3.4735400320614316,2.5169676765032403,1.20225968575125,15,7,20,60,150,40
1.8705163610859943,3.6870139128290895,1.7646200498899876,0.5045763489009367,20,7,15,59,144,44
2.3085759992022767,4.1806039385691856,2.1551749158573745,1.1639205866549378,21,6,10,62,147,52
1.8433052999188708,4.169667951511334,2.422927272270735,1.3204535118696938,24,7,18,64,144,46
1.4490088379469508,3.8174179966711916,2.486632740830377,1.2706349207600094,21,7,16,59,140,43
1.3308694825936485,4.00204990549927,2.5289955933404986,1.234591500214477,23,7,16,61,140,45
1.7240573024479207,3.57303889095255,2.246016780965894,1.3509111558410511,23,6,30,64,142,34
2.0401154532390873,4.189757663192053,2.5293861979849424,1.5286962363057524,19,7,43,64,142,21
1.779656208538368,4.391207741830569,2.8323307133261277,1.3877717857132332,24,7,32,63,145,31
2.010716906314413,4.279317670866254,2.576908019664231,1.281069835347549,20,7,9,59,136,50
1.6398752891403512,3.602980664171646,2.1475273879198205,1.021534845693992,15,8,15,68,136,53
1.6891080825004954,3.5279191282024236,2.095728852895182,1.1746588877600384,21,6,19,61,139,42
1.6559477753080305,3.929663125175968,2.3393664564574577,1.320668515653691,21,7,40,64,144,24
1.5928628761775947,4.290837399039383,2.497740114374479,1.5567335112416674,20,6,16,62,140,46
1.5490019876837626,3.679223382943677,2.2412419224579607,0.7376306749277015,23,7,11,61,142,50
1.6774150985958363,3.4718435733805766,2.8337815518545977,1.0121602312407432,13,6,10,61,138,51
1.7060493209529113,3.8776105767023,2.766332310625358,1.8009635969810485,49,6,22,65,151,43
1.949247213361242,4.183125522156416,2.202089510207672,1.3691251515479896,18,6,16,52,145,36
1.599678459372254,4.284499414173251,2.8141007255611425,1.4835428733695197,17,7,26,62,144,36
1.9537750455786933,4.923827606320701,2.9207703324529892,1.6316242655626434,23,7,21,59,140,38
2.0317719033078134,4.277720119502343,2.7721093741588874,1.6695973664962234,50,7,24,60,142,36
1.6465750436356914,3.862800333509532,2.3388831142677966,1.1912418947816479,21,7,22,61,137,39
1.75786022716046,4.150517622508486,2.103090129390914,1.2893886473846778,16,6,7,61,140,54
1.6615855647628701,4.137601389332926,2.3764529805957295,0.9102587919610702,21,7,17,57,151,40
2.04321961054661,4.094725385841267,2.6334012956565447,1.4401390374831942,21,6,17,63,150,46
1.970934579227987,4.386814405376242,2.4590668647083067,1.5552983986261397,24,7,11,63,158,52
1.7736894923189992,3.9647745699453507,2.272829881872019,1.2427259672597932,25,7,26,63,167,37
1.8931766732157702,4.509345465858241,2.767567609012093,1.514343678321761,19,7,32,61,169,29
1.7097640554485483,3.8150487740426042,2.3221444522483448,1.2522779551557779,22,7,30,67,164,37
1.7995414517144699,4.0382252975532165,2.386535610819669,1.3106585117671286,24,7,21,66,171,45
1.3569363635540075,3.6150033940796766,2.286109571979553,0.9983131599643074,23,7,35,69,161,34
1.9198305629808785,4.420134839505934,2.6409403373233835,1.436198093632013,16,7,18,61,162,43
2.0380142271620647,4.61876462544026,3.0876115162682805,1.7308398165342802,24,7,38,59,153,21
1.7706830444779678,4.4787671980744745,2.5115601045704454,1.5296657248001513,17,7,23,60,158,37
1.8408141820974262,4.379993762965382,1.7474972539351072,1.3307521134742473,20,6,5,63,147,58
1.9962424434535733,4.336514104340368,2.468373107327464,1.4920623352823754,26,7,21,63,149,42
2.0957474372527543,4.199760938288524,2.5480191582474383,1.6746826777249582,24,7,20,64,150,44
1.8561916122825992,4.111722497097965,2.493981129153984,1.3964335487275936,20,6,38,67,158,29
1.7732607162652905,4.246946909831433,2.718373604441077,1.486486189384804,26,7,41,61,161,20
2.21241386934527,4.798745319714081,2.865994590833379,1.7892546490175225,22,7,38,63,159,25
1.9916739060635251,4.6446230525419825,2.7025277682110156,1.6697089941190009,23,7,28,65,162,37
2.193837976687421,5.299576168898293,3.1034053597515405,1.9116037097902967,22,7,19,62,158,43
2.237422661180764,4.627244450848346,2.932247257448027,1.8512275220416115,16,7,42,64,148,22
2.042001756464205,4.324632019460174,2.615270204065132,1.4827485938447356,21,7,17,66,150,49
1.55721750813874,3.7712057010093893,2.069418853644276,1.0331051472878592,17,6,19,65,156,46
2.033188122526207,4.250111650168211,2.584771708087875,1.6594660945153301,24,7,31,60,152,29
2.0035876764365463,4.4582119345964575,2.591338931409111,0.9583966143553801,28,7,21,64,153,43
1.764579464941937,4.5146183877668005,2.773737079360915,1.5960967931748709,20,6,20,62,153,42
1.4990660899862114,3.752173914682366,2.301466818722367,1.0254454666939365,18,7,37,61,144,24
1.881660374432198,4.036414770496096,2.680036127320691,1.4278214580565454,18,7,20,62,150,42
1.57309580196983,3.674331329307771,2.669256099096824,1.4909991846869017,20,7,28,65,149,37
1.8480915796192359,3.7996554620994365,2.4184778307937975,1.443908058092888,19,6,39,65,158,26
1.7766325859678986,3.9963665140613,2.269167170300065,1.3407967628469235,49,7,10,64,156,54
1.459890428094189,4.036951647242183,2.1394814167381586,1.2371739202832455,18,6,24,60,152,36
1.9784073103708615,4.378989917956433,2.677406863851986,1.708879936849608,24,7,18,61,145,43
2.123141914816947,4.724106843993569,2.779102179224346,1.6684898316084746,25,7,24,61,147,37
2.1029955465083563,4.549596470458275,2.9962662830525506,1.6411233014574433,23,6,41,63,140,22
1.800875097664929,4.050952799717263,2.734716626768657,1.5303676319517165,19,6,22,64,134,42
1.8800495936001154,3.977634027266262,2.4983562201844385,1.2638053570798307,20,6,40,63,141,23
2.2465887037716454,3.930692351850145,2.483968795071188,1.6709336741837058,13,6,8,69,142,61
2.55144908044324,4.793537341482088,2.897755581037532,0.8475911365769635,24,6,18,47,139,29
1.9103879451544397,6.071726250398447,2.037556347403045,1.6111185520175004,49,7,11,27,143,16
1.9466341314855466,4.703527371728549,3.1588516394908694,1.8012567628432365,23,7,27,66,141,39
2.225328535561748,4.980348847847699,2.783206441637621,1.6403099798408236,21,7,28,61,137,33
2.227443434747157,4.105536741944863,2.789540083405855,1.7006042458557,20,6,30,61,149,31
1.8956832543716546,4.719381163470523,2.4423964063288,1.3977931776726447,17,7,20,61,153,41
2.4153003702090947,5.311361546852621,2.9379432299753296,1.9712275710512057,25,7,42,64,157,22
2.3540903447170116,5.322937073228957,2.8910668467033913,2.0575819268287754,19,7,17,63,151,46
2.120020051010628,5.088583251505378,2.9390165219929467,1.8280533822068232,22,7,42,62,148,20
2.150963714900311,4.652017605713629,2.871684662022571,1.6981163284133072,25,6,38,64,148,26
2.116052608021313,4.707416625908111,2.7638507614216183,1.6068949532763028,21,7,28,61,140,33
2.001750512439352,4.522856678306082,2.6352387464297022,1.4710694657620487,16,7,38,60,145,22
2.5155519702437217,5.216479146997353,2.867713497875186,1.9273911961757828,22,7,38,63,144,25
2.470456620829271,5.297447558799013,3.2429777774245188,2.0074381882917267,22,7,35,59,136,24
2.3699996634884433,5.3058208829170255,2.8771837893569696,1.9427803206948953,21,7,33,57,137,24
2.461595867332018,5.172060874198925,3.065744654360375,1.8352492677305372,17,6,37,63,139,26
1.891734864943529,4.21844985884127,2.441029450570775,1.4259409590077503,19,6,39,62,138,23
2.352099615751942,4.861569650391331,2.9539932517319194,1.8764334662530433,22,7,29,60,134,31
1.9304840027962633,4.713164806552084,2.527958094915093,1.4244882011600435,19,7,37,61,133,24
2.1549329612506947,4.458710823803385,2.6584118652973014,1.6309933215552919,22,6,26,60,133,34
2.283941619883679,5.191417599282175,2.7963685760883745,2.028884515961563,22,6,24,65,137,41
2.204560010283166,5.2007465228387435,2.8751203533076133,1.9376466447646776,21,6,40,61,132,21
1.7333960033223819,4.659363958641132,2.4500854702757198,1.4574019914379728,20,7,38,61,134,23
1.833742515495375,3.962373825311343,2.38387646913833,1.3205280782001547,23,6,19,58,133,39
2.0217376377898986,4.576831896093104,2.5157976762853744,1.5203444164094408,21,7,31,63,136,32
2.34349893550699,4.422470776994444,2.912555248912311,1.8951910822491682,21,6,21,60,144,39
2.0350337537102425,4.786074590226507,2.7266879437949694,1.703600698250525,19,7,26,62,148,36
1.8749960775809842,4.630514572305604,2.678460856354951,1.5370816260111066,24,7,27,58,152,31
2.422116603609012,5.595909649236314,2.743202642719591,1.8512285782283133,21,7,18,60,145,42
2.10393037126957,5.09489847848552,2.7473006365452877,1.7584327979944854,25,7,36,61,146,25
2.064486875513802,4.169911855377096,2.667820741339899,1.6041359845058833,16,7,27,62,143,35
2.4507058678883036,5.854180412015059,3.1866679852667574,2.2365507756953886,22,7,25,61,135,36
2.5390243352566846,5.243092448306102,2.7466507699236,2.050979095017838,24,7,8,60,133,52
2.128301517898774,4.97184079074953,2.436942039760046,1.7372621192414617,24,7,15,62,129,47
2.03624588764024,4.662431835203559,2.5966132925902246,1.5149073060799751,20,7,37,71,131,34
2.082153652551301,4.5375509745733975,2.650980348451708,1.7044422058635949,19,6,37,59,133,22
2.1258495738002563,4.660795867249797,2.890698038077363,1.5654204367307898,17,6,24,62,136,38
2.098934579343605,5.051357213868396,2.5393762456270275,1.6735968228349227,15,6,14,61,136,47
2.204405310399194,4.824369266816506,2.727213622448215,1.7103792738460972,19,7,36,62,134,26
2.13093440347475,4.213738201985839,2.6655192440166564,1.6645604446382594,20,7,40,61,135,21
2.0452602053050817,4.598949680199267,2.6700106829218386,1.587139433697365,22,7,39,62,146,23
1.8158123905518884,4.156073447888582,2.375234196412456,1.3922133240831194,25,6,39,56,151,17
1.8211816196382684,4.572037015745235,2.878673393452602,1.1354545464061436,25,7,27,60,156,33
2.192432810102092,5.312243269680856,3.331833905814621,2.003715550146498,14,7,23,61,150,38
2.2669724782184417,5.005203920629473,2.9961131081411003,1.8079303426531097,17,7,31,60,150,29
2.1739302553339694,4.803067366193607,2.817849082760168,1.6636989791292183,23,7,41,64,159,23
2.082104592276817,4.975900553747456,2.8697966145853107,1.7820989926032687,21,7,38,64,162,26
2.1611064529590225,4.9578555594266405,2.651881346357683,1.8392659905458344,17,6,21,64,161,43
1.6405539197995311,4.402145363679341,2.121570312152655,1.1505044123730837,21,6,22,61,156,39
2.2786246458210355,5.309022318224652,3.026845351451487,1.9568693898021006,24,7,34,56,148,22
2.282103729483927,5.142285571355919,3.1237495003409537,1.854856612430363,25,7,37,62,154,25
2.401437485621567,5.247300038366259,3.098875859909198,1.9574370386679916,23,7,28,64,152,36
1.9384401905767934,4.813518007414197,2.7017740322806136,1.4074579438853831,18,6,41,64,141,23
2.319030391179928,4.716497107032117,2.942361973041093,1.8252206166285547,19,7,39,64,144,25
2.2032269986470614,4.939823865966136,2.8214069074075745,1.6889021733696359,20,6,39,59,141,20
2.1331454094777125,5.06839006857194,2.523911985312414,1.4689243082384227,14,6,30,65,147,35
2.0447412451050386,5.038265938599761,2.507395092739649,1.4333011259611144,22,6,37,61,146,24
2.466348701507112,5.653088939307481,3.218638185797405,2.309716809158863,21,7,34,62,141,28
2.2699816975221294,5.03265724438538,3.007585379560236,1.6806298537271374,15,7,33,66,142,33
2.150599252700143,4.7519332744365625,2.900052617750034,1.120864562717166,21,7,41,66,136,25
2.3332705651593777,4.887531439401908,2.9914541378051016,1.7988514708168815,23,7,33,62,139,29
2.3515133751972597,5.207063129512287,2.943532444048266,1.5151397981894374,21,6,45,51,142,6
1.9672238287384995,4.676743978783378,2.6490619218524003,1.8082311531484687,20,7,39,62,141,23
2.0245323124185397,5.089510852005194,3.329999432172863,1.5854931515230728,16,6,37,57,134,20
1.9669391054636245,4.144588526145968,2.509542206094905,1.5992831367401548,23,6,36,63,141,27
2.204663290234858,5.0886644384109925,2.6964635423008003,1.8244842749844903,23,7,16,60,139,44
2.3815914867281167,5.220372375549088,3.163625339840892,1.6501691043670983,19,6,41,64,139,23
2.417470614067106,5.320834735085189,3.2336024924772824,2.539565211683801,15,6,42,56,134,14
2.2932283443912658,5.05258106752345,2.886036185302596,1.8578506801313717,21,6,45,60,137,15
1.9434835013537932,4.923182276426848,2.7951783489021103,1.7218676313588184,22,6,36,67,137,31
2.139920703725217,4.750653364468091,2.582100662741114,1.6859173337212139,19,7,22,58,133,36
2.118082893975321,4.7040748504450995,2.8745525910111995,1.3566878088975467,17,7,38,59,134,21
2.104672212693738,4.280951789075752,2.772237018616633,1.614186566880001,20,7,26,60,130,34
1.7088959010407123,4.300890329051114,2.055301969818534,0.6935503561057075,24,6,31,56,129,25
2.0584412729202595,5.133521436458809,2.5317319755504015,1.5930564015887039,20,6,17,58,134,41
2.1607004105915437,4.873112761193161,2.696450844021483,1.8043435246837072,26,7,33,58,135,25
2.116715302229892,4.809037003770352,3.0130761233261962,1.8435787504584935,22,6,41,63,137,22
2.1858021922883464,4.820695732703177,2.872640461704902,1.7830319976097455,21,7,42,66,138,24
2.172205045595895,4.767467524429309,2.6652969087744562,1.6087599678577744,22,7,39,61,137,22
1.9333080064660007,4.198073008361087,2.6749390422304358,1.5395530554093235,20,7,18,61,138,43
1.6443028096947174,3.7373010988622872,2.285952522084009,1.2135613158743248,19,7,25,61,144,36
1.7950652911066685,3.161818724269223,2.352136202314709,0.9077755442307386,18,7,19,62,152,43
2.2043458445951782,4.760146276242208,2.7337628598002146,1.4811488481814337,23,7,30,63,149,33
2.1011732018496647,4.911209154481192,3.271955099594793,1.9345592615523506,19,7,35,67,143,32
2.1695017811978663,4.3922869189855085,2.7627495229598598,1.7145480782508213,19,7,29,63,140,34
2.109180862492214,4.867906617002898,2.8043670505168903,1.773390954771938,22,7,40,64,139,24
2.206544576975256,4.898791657571181,2.899871283479593,1.9064648873005727,13,6,41,64,141,23
2.3096912621935464,5.4032308955050965,2.889918426426298,1.9621497349782915,23,7,19,56,137,37
2.2855985483039607,5.158254675830525,2.954169720661603,1.8691194081844968,20,7,29,60,140,31
2.413038355770131,5.2639735340508,2.834500795190515,1.7840710560531834,22,7,32,62,136,30
2.3552584571741493,4.7464183336255354,2.7903420429720196,1.956684387178106,23,7,40,59,136,19
2.3523006415687284,5.320491797440772,2.920550587257926,1.8668713269531345,19,7,41,63,138,22
2.2056913182303814,5.179028137413409,2.867581507168588,1.7274245711698932,19,7,29,62,138,33
2.412415831240036,4.651595941044834,2.77064088454208,1.8217552864392754,20,6,22,64,150,42
2.1782418016158847,5.218131721686181,2.856338680432258,1.708503514132523,16,7,41,61,155,20
1.589539739667456,4.679295424915453,2.413328882428274,1.2569812635862125,20,6,28,64,174,36
1.6827506360162663,4.594155167741094,2.1108120472087526,1.2462064060033216,22,6,24,66,172,42
1.9003324607890075,5.167868236625219,3.0006174343093015,1.8109570790816636,28,7,23,61,171,38
2.2179142643311933,4.740155971085471,3.099722649399106,1.969717273291486,20,7,35,61,167,26
2.1859464116371323,5.077953085979825,2.895831428555942,1.6446065834597303,24,7,37,62,165,25
2.095742005354829,4.530893623029299,2.899431199497056,1.5851694253684194,22,7,41,64,165,23
2.277901040975216,5.022958823214859,2.8853384902204042,1.7173997532906289,24,7,38,62,156,24
2.3073814174168668,4.746431911166468,2.9183184937018876,1.8400734656898246,20,6,27,62,159,35
2.31094501565157,5.189085314027853,2.907551835884202,1.9064502337657037,24,7,43,64,154,21
2.0863492119486895,4.990899619509668,2.7434357349883474,1.6506610125592598,22,7,36,60,147,24
2.2965474867834357,5.01791494134574,2.9768657428905945,1.8561369840810333,25,7,37,64,146,27
2.2843152157528728,4.935358413403804,2.9190831315895203,1.9195174701695157,21,7,26,63,146,37
1.9371976634046315,4.865727024287391,2.5552455042700513,1.6683973091460054,22,7,32,59,147,27
2.3701440499314588,5.447768115581663,2.9979071535239754,2.1283780428640755,22,7,37,63,145,26
2.3921355822348316,5.138857349375842,3.075472514579983,1.9887571944982594,21,6,40,61,142,21
2.0819360459804606,4.731952550648632,2.665717547133515,1.5810821082919893,23,7,26,65,142,39
2.3488404005526946,4.992813271639798,2.913821153783928,1.7542508105208205,20,7,34,63,138,29
2.314992359782497,4.75462715480918,2.809044144818696,1.8433910720425937,17,6,41,62,141,21
2.3725569599741276,4.99203692763347,2.8676863016773346,1.951966414468018,19,6,41,63,143,22
1.9543755183009277,5.016217049858552,2.6809013438806706,1.695662475810765,23,6,38,61,143,23
2.337269842421481,5.596904923828231,3.176447876356756,2.1564663482856474,21,7,36,63,140,27
1.9884294422947064,4.859422392452251,2.645912884519371,1.5359634554692159,24,7,39,60,141,21
2.2702620631011405,4.6558530656355686,2.8620374772048165,1.7152359553187766,19,7,41,63,137,22
2.263446953454779,5.313810092049224,2.9177222492266974,1.8867683726502564,21,7,42,61,139,19
2.1403596909645226,5.060887448401123,2.804897669398021,1.773302215547068,23,6,34,62,137,28
2.3882764340235023,5.171012443875174,2.9786425120829785,2.0885532326320257,20,6,38,63,141,25
2.4990848342514576,5.733927734918402,3.1784989998662176,2.0934239264799643,23,7,41,62,138,21
2.4361629210198266,5.446567752420455,3.003501601516119,1.9656918396374372,22,7,40,60,136,20
2.2147648146055765,4.896498710313769,2.7789345683789444,1.8199172977150415,21,6,38,63,137,25
2.293058644995114,5.097676678929795,2.8029374826378004,1.7920145591911376,23,7,34,62,140,28
2.004520876701209,4.884095726528604,2.6522158129964746,1.752291269182817,20,6,39,61,139,22
2.308834361043634,5.4591683017607675,2.9985667308401927,2.16884281281803,21,7,39,59,137,20
2.3980845569902103,5.155369341676982,3.0038585584945503,2.001025251450792,17,7,41,63,139,22
2.3728010226747096,5.10979854351214,3.0464240194439776,2.061712127562151,20,6,39,64,135,25
2.2229776080799164,5.010511475543699,2.6915626963839476,1.7725940786943528,18,7,37,63,136,26
2.2936428465758634,4.942838066516096,2.8338493758541246,1.8989567857048908,22,8,29,61,136,32
2.094404992216904,4.561279821388416,2.722893133485245,1.782305099580677,20,7,31,62,137,31
2.3492926537193752,5.322106878093689,2.935063585968118,1.9111667269104768,21,7,43,61,136,18
2.0722049303349346,5.251704183044041,2.681667647018741,1.7497262316542057,21,6,41,61,140,20
2.591721071279742,5.668780238437398,3.3185545852931506,2.2741967501214524,15,6,33,64,139,31
2.305975665045679,5.045072085998587,2.97535636820651,1.7620606431616332,19,7,36,61,138,25
2.43272231969491,5.078825868959491,2.936495252692068,1.9436087341959074,23,7,36,62,141,26
2.096296369081164,5.054752782533686,2.733350049953986,1.7120799825808872,22,6,39,65,140,26
2.073225300745698,5.065599543891178,2.588813833180421,1.591141579764569,18,7,35,61,143,26
2.281890558079871,5.326469914788504,2.8054356847722173,1.935351323079836,22,7,27,63,137,36
2.371418372020597,5.127394055640507,2.9659953989048087,1.8786942008223912,18,7,30,61,143,31
2.2966714005336946,5.13931496034103,2.860684403851131,1.8987557940427728,23,7,31,60,140,29
2.328551814620799,4.677515254657575,2.9027027773531655,1.9169052362123433,19,6,37,62,144,25
2.2870826414663035,5.356832940546033,2.9509931473615154,1.9768611990062195,25,7,39,61,140,22
2.486155460419423,5.540044376109023,3.13826051376175,2.0954904908068803,20,7,39,67,140,28
2.2353586586566347,5.079372944833745,2.885299651689074,1.9577543016305543,25,7,40,57,137,17
2.2396388979435633,4.799511675947058,2.5933384461525204,1.6198510385166687,23,7,36,58,138,22
2.468145038734932,5.228302486623858,2.915448074470304,2.051528254643045,16,7,39,64,139,25
2.4095121789266307,5.5487402677334945,3.0437310696478383,1.9850523775692082,21,7,34,63,133,29
2.345573887216649,5.1833546407193385,2.9693229283406226,1.9908341389275217,19,7,36,58,130,22
2.377034231401039,5.061633760314545,2.9864508330438646,2.016589227038825,23,6,34,62,132,28
2.4797897267782867,5.454343552831707,2.984021768148353,1.9167458174009868,23,6,31,62,132,31
2.203188024131644,4.925664976714369,2.675684008197011,1.7630598257839625,24,7,20,59,129,39
2.31158566403441,4.864936398866402,2.831671202086163,1.8769600501989812,21,6,32,61,139,29
2.2501545166133816,5.216279487981506,2.8305139873352196,1.9606344810487566,21,6,33,61,138,28
2.3571120867241175,5.274755787967511,3.0291241612645825,2.043435091529757,22,7,35,64,138,29
2.453910770401673,5.4298073016183155,3.0346621634816833,2.05586817931364,22,6,37,65,140,28
2.444272361276474,5.460519259195984,3.037654677974291,2.0948360175048126,25,7,33,62,138,29
2.201018761484979,4.78388316502605,2.7334535645738227,1.7536819354384017,20,6,39,61,138,22
2.0520164531214276,4.708184242266546,2.623436238811783,1.583755051321495,18,7,33,59,137,26
2.2790353278313256,4.6901661979029035,2.7953880800890523,1.7722773812838286,18,6,26,62,142,36
2.3983983028031197,5.500775209562905,2.98255368306364,2.0492556144197804,23,7,33,60,141,27
2.02589266940204,5.144919936843414,2.7676191754018364,1.6080278795829281,24,6,31,56,133,25
2.1763858395706515,5.049915375405975,2.820767232636553,1.7924089765028053,21,6,28,61,139,33
2.242345156600669,4.830280212907859,2.775573604944972,1.8234531800719553,26,7,40,57,138,17
2.284613237862999,4.829724707946879,2.9061063838235275,1.8274695215168604,18,6,39,59,143,20
2.2911311287519656,5.3787803081888335,2.933937747154393,1.9067594919389141,21,7,40,61,148,21
2.2581404505547256,5.264396143829348,3.016760323777067,1.9496269169475453,21,6,34,62,150,28
2.3814683563348265,5.672480252447132,3.1065229846196685,2.089980914590586,22,7,42,63,150,21
2.3316569702753234,5.342202599884521,2.963473667152108,1.7996668835886935,22,7,42,62,145,20
2.0914872598729253,4.820553934977852,2.6687025337694403,1.6975740262625685,19,6,39,58,145,19
2.4221994525451036,4.87876402247111,3.046684647330285,1.9598658074038333,22,6,39,63,149,24
2.425983013337264,5.541169757357315,3.055920201189673,2.0511129304416222,23,7,39,62,150,23
2.552906874427285,5.198637730085693,3.139199809683252,2.1045299393231254,19,7,37,61,142,24
2.4229406188360443,5.270452453569153,2.968131133124682,1.8977864023627964,24,7,41,62,140,21
2.257361142402328,4.932013868729691,2.8874405625756174,1.8180752211820854,18,6,38,64,144,26
2.226156988373692,5.086061258153439,2.791149432109116,1.8157229548490794,22,6,40,63,143,23
2.3754264568519323,5.138212781947111,3.0240060678617664,1.984237411151052,21,6,39,63,148,24
2.418646280109438,5.467599765829373,3.1310680127792647,2.0292565785561423,23,7,35,59,140,24
2.231501456376361,4.946248064117506,2.7702969226464287,1.813647182968897,23,7,25,60,138,35
2.107777205491738,4.5652762433214615,2.766916321574198,1.709370128989784,21,7,38,64,142,26
2.0546585624259306,4.3547024511013355,2.6010271338441577,1.5072276033402385,17,5,33,59,147,26
2.3706721525499943,5.365032963161381,3.0611449229936474,1.9752254127024547,23,7,34,62,147,28
2.367502669180895,4.900460278335668,2.9808118090491367,1.8953685471688382,22,6,40,61,148,21
2.110761769775368,5.273015927089179,2.70202803354845,1.5800508836965532,17,7,36,62,144,26
2.141265461578167,4.724336764409806,2.7222894412563097,1.6620072843072817,15,6,41,65,142,24
2.4280769932040354,5.204930042277018,3.0196577830931166,1.917363451665679,15,6,40,64,144,24
2.336239514230125,5.272099642655323,2.852362401469509,1.8472801773237881,22,7,40,65,146,25
1.8868971732952693,4.92911215582988,2.457543678905621,1.3704016689793321,22,6,33,62,145,29
2.2948105267428476,4.744093910739242,2.7855403754975465,1.8409408047719529,17,6,41,65,147,24
2.299188446002518,5.055827744932996,2.849614569893749,1.9278078772925094,21,7,41,60,145,19
2.2853482339279916,5.273945787856338,3.0015921608476384,1.318510312667885,21,7,31,59,148,28
2.1917880338938094,5.152287509659909,2.8112559615107227,1.7689169304072945,19,7,35,64,149,29
2.48828398077758,5.320236727836518,3.0991656203936215,2.013632314844516,18,7,32,59,140,27
2.1090677716975668,4.84504332220196,2.793049512610332,1.7609610958479767,15,6,33,61,143,28
2.4491333369542643,5.661024595851282,3.086643804730815,2.105188502733755,22,6,30,58,139,28
2.4193631167021836,5.54156434674823,3.0712499689652475,2.0210080583575563,19,7,34,66,141,32
2.4749629071156907,5.354951466193674,3.032776325034688,1.9935802981074404,23,7,32,58,134,26
2.2772893218902857,4.889786314662732,2.8253956059791694,1.6304295197995162,21,7,41,60,138,19
2.2497700301622103,5.085546024234784,2.7595186366529414,1.6918118696373186,23,7,37,59,137,22
2.3053007117615216,5.414917752458598,2.8349750475285718,1.9376629729790522,22,6,39,62,142,23
2.3667197235297053,5.2991376036620945,2.9619072812336764,1.946841142010254,22,6,42,61,144,19
2.493851409286952,5.554359716118312,3.146779674011428,1.9678141402645313,21,7,39,59,140,20
2.3092974366584413,4.8405581044813415,2.8612932386808616,1.8267268879642597,21,6,18,63,143,45
2.2008545455719375,5.0141209824834,2.8485368953823897,1.7871515833810105,18,7,37,60,145,23
2.22748904754061,4.989394760363163,2.9003323454431937,1.8293268338462978,22,7,40,61,150,21
2.2271904399739673,4.707618904763244,2.8980388976712366,1.8305061484527227,22,7,36,65,153,29
2.3101582406804937,5.181456384245181,2.8917499524387846,1.9566803370068817,22,7,40,62,153,22
2.4187908498354234,5.510354406153121,3.1068079742444574,2.0423654751640745,24,7,36,60,153,24
2.411106196394302,5.64737352493195,3.053374983016987,2.0924187943913997,23,7,35,59,142,24
2.311787322211728,5.090147765552196,2.9286534186076767,1.8495402222881645,19,7,30,61,144,31
2.233088942920894,5.055355105534825,2.8573417991902574,1.7801725557842638,22,7,38,61,143,23
2.214286561818225,4.558620597565415,2.8447554450851085,1.7666984536907204,18,7,41,58,143,17
2.4333841994088004,5.377595741023101,2.9454868083202213,1.8576010450336118,21,7,32,62,143,30
2.468481345793394,5.488537852737107,3.061099587277763,1.9805183089636116,19,7,42,58,143,16
2.1747619207513154,5.483540577378919,2.858968113451524,1.7620580298546786,22,6,35,62,146,27
2.29556969351211,5.2276606159837895,2.9621695181101506,1.8551679797628244,23,6,33,60,141,27
2.350399977235143,5.03161631376055,2.913096091959697,1.8068556843795418,24,7,42,61,144,19
2.2001419450822484,5.045998539026624,2.896733031317764,1.7457704966619965,21,7,41,65,147,24
2.263490982296191,5.351075669870703,2.977981754824106,1.8252351484458469,22,7,33,62,143,29
2.382484305948462,5.309244270807639,2.9882547563463064,1.7752323245178316,22,7,40,60,139,20
2.3951658273956107,5.349925795221445,3.035130750587825,1.921519667955854,21,7,38,61,141,23
2.400879468327555,5.77296825647883,3.071785604459234,1.9564061575223821,25,7,30,58,142,28
2.337900118544844,4.785892227553214,2.9732681549010187,1.8413617054289935,22,6,40,64,140,24
2.3855857799709264,4.894831169366549,2.8598272997685914,1.6892445801069569,20,7,39,59,138,20
2.33844062720883,4.76356267812233,2.8696644075364457,1.7324193381249684,16,6,31,61,139,30
2.3222083525602364,5.251267908448808,2.952122831700782,1.7942485524411382,22,7,31,64,149,33
2.2424928744063286,4.74168012355115,2.8545439746648382,1.78145061346966,20,7,32,61,146,29
2.3945706923426053,5.426296177380783,2.9775054622712176,1.9684492172571746,17,6,22,62,144,40
2.3179792101130996,5.293696714546341,2.9779707058672713,1.9131272908645411,22,7,36,65,145,29
2.236313185704985,4.95015167737369,2.797357987924542,1.6645357047330696,20,7,37,62,146,25
2.245134109193727,5.221607957128814,2.9376656201563254,1.8080428931503552,23,7,39,61,139,22
2.335761643395101,5.296419683881444,2.905031742925159,1.8606551759716412,18,7,39,55,136,16
2.3731538439737054,5.2421748504320025,2.940609497432546,1.9627728169021492,16,7,40,61,140,21
2.292442351622071,5.159054131249928,2.880787784699237,1.77575795897674,25,7,37,62,142,25
2.2847997062108547,4.635788879497774,2.9259234329212673,1.770758462852984,19,6,34,59,139,25
2.151720066229893,4.810231186943373,2.6953175379915746,1.6007737534575752,25,7,33,60,138,27
2.0010640586520942,4.247047149092397,2.4987116342824693,1.5453585642379912,22,7,36,57,136,21
1.843773914370432,3.5058762232443925,2.2908773360006176,1.3875633991374112,23,7,39,58,141,19
1.7359301761793844,3.418306840398512,2.151939034152519,1.1946805723341662,25,6,22,63,151,41
1.9409522144300078,4.172710035014331,2.467432781200554,1.5352548774732147,25,7,31,66,159,35
2.1142269735563994,4.69243128109427,2.6930552110879127,1.5970846740036244,17,7,40,59,153,19
2.262419709810072,4.963906238073152,2.8543345539883154,1.795602919863914,24,7,33,61,152,28
2.2357656964539006,4.949804401961538,2.8123993524166586,1.6485011508727587,21,7,29,62,148,33
2.190570974200206,5.064786777916037,2.8504038180235534,1.760377489222508,22,7,42,63,160,21
2.2810105869384993,5.234991776844748,2.9559102489166253,1.8807609290371734,21,6,41,60,155,19
2.3568478229381125,5.206296850184814,2.9936958830016924,1.8782086679917813,23,6,34,59,155,25
2.28984837920457,5.32839169105714,2.9142013548080046,1.8875213772242498,22,6,35,61,152,26
2.055493712816365,5.077661016573743,2.792140990490626,1.7006968426430196,22,6,32,63,146,31
2.0827481236380114,5.081803872046576,2.8760907889828733,1.6349800955991682,20,7,33,58,139,25
2.2627629788421806,4.875435450575809,2.8213777384932452,1.7202210236359523,24,7,31,60,142,29
2.28118911210691,4.955688530201753,2.8528583462104726,1.8143825050887907,16,7,41,60,146,19
2.2721954704129415,4.6134092295205225,2.8106748700576847,1.8189870331230387,23,7,33,61,150,28
2.3511204170098914,4.797254620983484,3.0041782345430024,1.9067126291252343,20,6,40,62,160,22
2.0560900205343726,5.009162720967357,2.694227040581737,1.6416545300732308,22,7,43,63,156,20
2.4297756503995003,5.272237464911121,2.9674362984267417,1.989152452023209,22,7,44,64,157,20
2.153927243260306,4.905335898165039,2.7127430669157833,1.6638791132828321,18,7,20,62,154,42
2.220707565424613,4.9514622919851226,2.6188609321031517,2.077965532099014,24,7,23,60,156,37
2.320595668411114,5.2694715501499,2.901226053997797,1.9528803830404895,23,7,31,64,155,33
2.3329777163206584,5.370271062848097,3.1510285490212153,1.9350573734318037,22,6,36,60,147,24
2.1977487358571692,4.722581992535007,2.875673035640258,1.7994439910384925,21,6,41,62,146,21
1.9964042510335984,4.803028644612278,2.6727373787115187,1.6892174219606981,21,6,26,63,138,37
2.2946396186490237,4.7959548451415985,2.902909653552372,1.8819157974944964,18,6,31,60,147,29
2.304032074282316,5.3569837673949365,2.953768396062082,2.0727082799963843,21,7,37,63,144,26
2.3293361663472485,5.24920187691952,2.880654783266198,1.9478723277472714,22,7,39,57,141,18
2.382499176377553,5.161069256413933,3.0629082092595663,1.923563800958603,17,7,38,63,139,25
2.2120537844422836,4.734600665748403,2.7716023899759112,1.793581641801766,21,6,40,62,141,22
2.257383558431928,4.768980692079721,2.798555947590587,1.8239338570807409,21,6,39,60,140,21
2.0836464799889116,4.700915798108486,2.6820891865109964,1.6630143283316614,22,6,29,64,149,35
2.268581464485384,5.01315846284143,2.9034048400947605,1.9085644917916023,22,7,40,59,149,19
2.2817970361586872,5.413897434031455,2.959033734246904,1.9561790622550672,24,7,30,62,144,32
2.231701405598572,5.252556410512188,2.9823654250773055,1.8384561654197198,21,7,36,60,145,24
2.361996473313067,4.987924061050057,2.980428749201974,1.8535793743653028,18,7,37,64,147,27
2.3794543141114453,5.175463873494246,3.009816869095918,1.92188403267738,21,7,37,58,141,21
2.3412906329035232,4.69946520739083,2.936547489257321,1.9262256147580916,24,6,40,63,149,23
2.1546115706644495,5.198969466033762,2.877594339157284,1.7609369850257397,22,7,34,66,143,32
2.757316039286415,5.258559497803329,3.524842962571114,2.2456909879332576,15,7,29,62,141,33
1.7361438323509342,4.742423807440899,2.5908221777763103,1.51704961713803,21,7,16,63,137,47
2.061714545199397,4.802891729828428,2.6589055751561905,1.5974295364977322,23,7,38,60,135,22
2.315507977914714,4.794786620151164,2.9344924651053312,1.9015612859353712,20,7,40,63,142,23
2.2586716776597826,5.375790588979674,2.900977902432651,1.9205026349384446,21,7,35,61,139,26
2.0431849980046373,5.134248173794277,2.660741875761051,1.5779201636110107,22,6,32,62,139,30
2.375669366238384,5.299371468712963,3.0145947673004283,1.9927932797456676,23,7,30,61,137,31
2.0829754898427986,4.884568932485966,2.6213798200485248,1.572379206984163,18,6,27,66,144,39
2.2773331584829193,5.08340141832671,2.8388761934368487,1.8337299485882366,24,7,27,64,144,37
2.138883807939869,5.009843867441282,2.755129614690847,1.9031518502483842,19,6,42,60,144,18
2.348963485093818,4.921450572389787,3.21010370235033,1.9704432591017749,20,7,26,60,145,34
2.1439214311090264,4.458915217172176,2.693338447635366,1.6661248250773282,19,6,35,64,143,29
2.245815303734838,4.80092702847908,2.86983734964666,1.8060885967799405,22,6,40,59,139,19
1.966275670037973,4.737360071407734,2.5982185846446733,1.5711953407330639,17,7,30,60,142,30
1.9578918026913525,4.795819094766965,2.576773405500628,1.6403273098145181,20,7,39,63,141,24
1.9477523541351887,4.82904430896921,2.5662686852261616,1.6317434988849082,21,7,31,59,137,28
1.948374804974293,4.920065085489512,2.5869579891812085,1.6197629141061627,23,7,26,63,141,37
2.023201519171075,4.956642869874932,2.4849005340819446,1.539470479066943,21,7,27,60,137,33
2.314253433665363,4.980570284564337,2.8373539280135893,1.8930000677150185,24,7,37,62,137,25
2.2159937186658873,4.877304900232852,2.6893781876573524,1.664454876613119,21,6,24,64,138,40
2.362803676033863,5.014449723012882,2.642306491998332,1.750715390699884,24,6,27,62,139,35
2.334002868456518,5.345382020619988,3.017104544539768,1.9932802062414714,22,7,39,63,141,24
2.5625454833167973,5.537779707766793,3.3848586509414096,2.208139195495238,22,7,31,59,135,28
2.3813555852382002,5.286530962104581,3.003269304457158,1.9833900645220979,23,7,31,64,136,33
2.159828580019949,4.231906812714852,2.6814338361220362,1.646801188496279,17,7,25,60,132,35
1.9752947418736215,4.51868631862733,2.4403549920499232,1.46753939120704,22,7,30,58,139,28
2.339229864908664,5.067286571926312,2.851917432333791,1.8091455442164786,23,7,33,61,136,28
1.9047476056911914,4.9152528074099076,2.4734587894719393,1.5513380186334134,19,6,28,62,144,34
2.4068230469129466,5.094614683641905,2.993297477791618,2.124006898795109,20,6,32,60,148,28
2.477666152087739,5.399457673447451,3.1034758664587465,2.026321174381925,23,7,36,61,146,25
2.207617233138085,5.046008297009051,2.8500596495539345,1.8190015764431653,21,7,38,61,140,23
2.244842789278962,4.89186173397759,2.77622632817022,1.748911742735498,17,7,30,63,141,33
2.197297838030133,5.060446206757818,2.8397222382550495,1.7933551087051933,17,7,31,62,140,31
2.289856832551205,5.324843633053643,3.030283763378958,1.8830580186230788,22,7,39,59,139,20
2.415242335549405,5.417937143812713,3.037723680454149,2.0253434937481947,20,7,37,61,144,24
2.488716749180684,5.4699983498206475,3.0950378381954438,2.0597462554694737,21,7,28,61,139,33
2.1487128754039384,4.827978218674316,2.9504311846016256,1.8066944919757775,17,6,37,61,140,24
2.290343079171931,4.78938688168596,2.8239249598122713,1.7824516368209187,20,7,40,66,147,26
2.2177793752376056,5.076757130148462,2.7394177550294585,1.7276111970921253,24,7,40,58,141,18
2.2661880994987835,5.170679987643188,2.8866059808758955,1.7929060130023071,18,6,38,64,147,26
2.2414567900733635,5.17507075680172,2.8631566205328074,1.8885511352143354,16,6,34,62,148,28
