1.2750761273153972,3.0175272276925,1.9864242075998952,0.8865473082061854,15,7,20,54,133,34
1.1584345174754158,3.1654269496787535,1.9950872028543793,0.9515800828007586,24,8,34,51,139,17
1.0441250523515637,2.827367852180427,1.9875406384849077,0.9679545959898824,24,8,30,58,138,28
1.1552199093603848,4.171645218979876,1.963178262370946,1.1845605681274907,24,7,32,47,134,15
1.2353144090648325,3.407822271096457,2.0031394747278037,0.9739571869099591,24,8,33,54,134,21
1.1342882627547706,2.870720125014553,1.9032665038844554,0.8434509359375213,21,7,32,49,130,17
1.0978281310798998,2.7755235244562693,1.7478736419730545,0.8417024922519658,23,7,30,48,131,18
1.006517101090229,2.849579247317777,1.7271575232944043,0.8635487166300213,25,7,34,51,136,17
1.0523370681799489,3.0741208751511984,1.7175850002603668,0.8236506990756975,23,8,36,54,140,18
0.9326599148214951,3.058240663943321,1.603082501959093,0.6712745307247524,25,8,30,52,142,22
1.16018419066578,3.2223160931456944,1.878065237031137,0.9563668964523908,17,7,29,48,134,19
1.2203340091638337,3.1003867308065542,1.9385509005836359,0.8882918391043726,20,8,33,52,138,19
1.0687675548845559,3.163474395742723,1.8830816899485354,0.9286014752780115,26,7,34,49,136,15
1.0502407322282972,2.8790105738960396,1.8282830670315562,0.92137763937299,24,6,37,55,146,18
1.0183890291111863,3.2203753513844138,1.7933152860050119,0.7747088198682406,26,7,32,52,141,20
0.9928554391302358,3.076060522199443,1.7954420687372783,0.7832705066465276,20,7,34,56,140,22
1.1904066296828963,3.080140416484693,1.9281858551324422,0.893258111393255,24,8,31,49,136,18
1.0462669903583117,3.095174063475927,1.7848055631032211,0.8751083605230354,26,8,32,50,136,18
0.9633219604780648,2.870004736411771,1.7303052240120604,0.8321936083039403,22,7,33,54,141,21
1.0062457740619004,3.126737603122413,1.814025839503713,0.8833561062056944,26,7,31,50,136,19
1.1167433774598057,3.295503832155621,1.9270681225193544,0.9532883169595694,22,7,32,54,136,22
1.2433830318933912,2.998900001487976,2.0300039655992657,0.9816184735922516,27,7,33,54,131,21
1.0276550995583413,3.1192020273864935,1.7630310388929487,0.8172673814235927,24,7,36,56,136,20
1.0778348212578424,3.0847517755130727,1.8991975648220065,0.9015212159226842,25,8,34,55,135,21
1.0139559884232736,3.0007347529237913,1.7681307069168446,0.7699725911686278,23,6,33,51,130,18
1.2476422729446046,3.315737527150242,2.0476773297587654,0.965135047324789,26,8,31,49,125,18
1.1114386604686244,3.112699140743055,1.840932257126757,0.9062218534403549,22,8,34,55,133,21
0.7438930443299587,2.5036318398696484,1.4924700854541872,0.5778605636905014,20,7,30,49,132,19
1.1235100976604386,3.1419572208384117,1.909516279658905,0.9209509220738455,24,7,34,54,140,20
1.0937421719522722,3.3032883209755304,1.9283246698278689,0.9107662699185156,25,7,33,52,131,19
1.1996105787730207,3.137052295037286,1.9799005942375851,0.8938510122396802,24,7,36,56,134,20
0.9281486229062258,2.9912280139312495,1.64792555823272,0.7220177831657754,23,7,31,54,139,23
1.184907649694741,3.307279336097987,1.9617970602510744,0.9663190775393392,27,9,30,51,139,21
1.0080004912009062,3.2788961809131325,1.7809825381164885,0.8560000347884291,25,7,34,53,140,19
1.1700482332200202,3.3072098445248117,1.9557858059987236,0.8903215767753188,25,8,34,55,133,21
0.6283465383880547,2.4214820274487128,1.3771337322124548,0.34234402030839806,21,6,33,52,134,19
0.9007977577953568,2.9016848233553363,1.6147608606066757,0.6864610946233758,22,6,33,49,139,16
0.9866343690423809,3.039485776849851,1.7666904056567787,0.7889804563370855,24,8,30,49,139,19
0.9721400668667626,3.1612874832234747,1.783795452366361,0.7496719023859183,24,8,33,51,140,18
1.1408826691680312,3.306135985491062,1.9220741976036233,0.8812807652360202,27,8,33,51,133,18
1.2330464615979646,3.164620567626597,2.0030013392865587,0.957106269964297,26,8,34,54,138,20
1.0215473699748878,3.063270181120447,1.7240790643740334,0.7848040665438953,25,8,34,53,143,19
0.9720357243348863,2.926433543945701,1.8069457676379237,0.8070813028016697,25,8,33,54,144,21
0.9072811883878855,2.8163220268082974,1.648534221490023,0.6781969939188683,25,6,35,53,138,18
1.1540043185681998,3.242474891761133,1.9247750641357284,0.885397475687425,26,8,35,52,134,17
1.0798208310987651,2.7827804162445746,1.8617675239778286,0.740632234133422,23,7,33,55,141,22
0.9339605657853183,2.875269223778425,1.6417202137606286,0.6689190687651243,24,7,33,51,138,18
1.0666267781414462,3.196073477787176,1.815640810176413,0.8342188412884858,25,7,35,54,142,19
1.1073350265370407,3.2906825969755276,1.843083992782013,0.8231494664089507,24,8,33,52,134,19
1.2186830649644114,3.1800436265544016,1.9314794277166523,0.8913580492786998,24,7,37,54,132,17
0.8272938741456195,2.5831429216001283,1.5786670967897543,0.49398074388718916,22,6,33,53,139,20
1.018287574224043,3.059592599068492,1.7733774796216712,0.8170226208289184,24,7,33,52,142,19
0.989755646197254,3.0875904836626313,1.703532602698226,0.7761853593444002,22,8,32,51,138,19
1.1224552972344881,3.2705377113451144,1.8981024807646527,0.8344650115125372,26,7,36,53,139,17
1.0613594246004658,2.9671509336313235,1.8677771775801495,0.8014835203666884,26,7,36,56,138,20
1.255799568159413,3.260180285674351,2.0594509333611217,0.9330470969672177,26,8,36,55,135,19
1.165232346724349,2.8318924006534267,1.8696331970029791,0.7840515255372655,17,7,34,54,133,20
1.073144161778148,3.1375510720602406,1.811802286884682,0.8400347682049729,27,8,37,53,131,16
0.8937706881163584,2.702697941998733,1.62391595963891,0.6092825217386034,24,7,32,54,136,22
1.0440633210711208,3.326379031973265,1.8455660182262865,0.8281541707331715,26,7,31,54,138,23
1.0924788594324568,3.0055775155408915,1.843863787787075,0.7847957551679003,25,8,32,54,138,22
1.2037690054054866,3.130579133305506,1.9438515065849282,0.9055111932605536,21,7,34,53,131,19
1.110947450220487,3.10999967400912,1.8714015791326974,0.861171463292923,22,7,35,57,139,22
1.056383106887757,2.8848236312006588,1.811635755198619,0.8083274207963478,20,8,34,56,143,22
1.052776849242571,3.0351601345284505,1.8028139219799943,0.7954925838251342,23,7,33,51,144,18
1.0763109365209458,3.274554657683038,1.908754925882203,0.8280602383692285,27,8,32,51,139,19
1.1557462163154688,3.1908528306186095,1.9120214228516141,0.8307776226396412,28,7,32,53,135,21
1.0921508189371552,3.1166535892741,1.8644907099725836,0.825239844024128,24,7,36,56,139,20
0.9569523184473476,2.8601568338248438,1.7619870037860481,0.7519474814098102,23,7,33,55,142,22
1.0649601374333417,3.0190468337178005,1.816423960349265,0.8342796811148641,23,7,34,52,139,18
1.1904152857333485,3.3782191553473373,2.0072150654630336,0.9503135959633061,22,7,34,52,132,18
1.2661087417550805,3.206222267275022,2.0959996116465893,0.9373461330814965,27,7,36,57,135,21
1.1347469231536609,3.1133670575035985,1.8641335584265366,0.9058829265833556,22,7,34,52,139,18
0.9953133751373318,2.864979370136768,1.6859610439876715,0.6966077071204366,20,7,33,52,143,19
0.9561032172131806,3.0959198617524493,1.7300094540916369,0.6615526593878971,23,8,31,50,134,19
1.1167322584318529,3.196411305360259,1.9153608541103329,0.8559917403948542,27,7,35,54,133,19
1.084616706611992,3.0146970029728632,1.7836279135843736,0.79635426497939,22,7,38,55,138,17
1.0641270223554937,3.1755819148898587,1.7985330130631014,0.8148498969370583,21,7,34,52,140,18
1.007457659940349,3.271720605795911,1.893014657608842,0.8452754722907984,21,7,33,51,135,18
0.9979181773621935,3.0184938480245456,1.7467350605649619,0.6541639795557183,24,8,32,50,129,18
1.1856141089187662,3.091751150981204,1.918790791536103,0.8667816395736352,26,8,36,58,138,22
0.9137636131481823,2.727009195585544,1.6324888454999869,0.6757561120508322,24,7,31,51,135,20
1.1089241790837678,3.070690812761924,1.8593676973861488,0.897835557379632,25,7,34,50,136,16
1.1870322154611865,3.1002884509838595,1.9536968226813372,0.8957630075356532,24,7,35,55,139,20
1.1398076374068467,3.1213926118597746,1.9187544525474356,0.8550335096382006,27,7,34,54,141,20
1.0952182201496836,3.2053042464399266,1.838544477739221,0.8379790866512328,22,8,34,54,145,20
0.9231601265475649,3.056197441944779,1.7402940569306946,0.7136996738627847,25,8,33,52,143,19
0.9235590090312602,2.9607624715132173,1.6908406419335102,0.7034623438715115,25,7,32,50,135,18
1.2866596090890168,3.0934765336323693,2.012802037209975,0.9291925495011755,21,7,33,50,144,17
1.118928859884689,3.1047942901824372,1.856931336600798,0.8154903126513455,23,7,33,51,146,18
1.0474443972733292,3.1322325948213514,1.798715640296589,0.8008835423432317,24,8,36,55,151,19
0.8130987783817676,2.971085299672298,1.67174160829232,0.5908649103784671,25,7,34,53,139,19
1.1867960180308188,3.2913535268114007,1.9342840594253314,0.8864169408645272,23,7,31,54,140,23
0.976387072915444,2.715698248550725,1.7983868315759501,0.716292995410734,24,6,33,54,141,21
1.0637923256186503,3.203490131764056,1.7916052392118291,0.7961869496391979,26,8,36,55,133,19
1.1238687982411113,3.3710028445580624,1.927828822458808,0.9065058424788819,25,8,34,52,132,18
1.0552617384809229,2.8770018520210385,1.8010789493819912,0.7089253051512168,18,7,34,54,131,20
1.1895346904306008,3.0338186611853417,1.9495500657965836,0.869448720944659,20,6,35,53,136,18
0.9476080605414756,2.9064282677900772,1.6545057635983857,0.7190070998427801,25,7,35,55,130,20
1.1365304805845184,3.295701825014032,1.8587966519318404,0.7598448996435501,23,8,35,54,135,19
1.3368422999663716,3.35482212597186,1.9777883049453187,0.9794429440499314,20,8,34,57,132,23
1.183533741447401,2.8905012110327784,1.9136372262047139,0.8419613842648968,24,7,32,52,137,20
0.9423545362155075,2.919125924707343,1.6243449381438149,0.6817940863760247,26,8,30,50,135,20
1.1395243635459278,3.2910099863243714,1.8868261124711352,0.9164584937371816,27,8,34,51,137,17
1.1877756014456815,3.1759335569535434,1.9270148152493405,0.8122276480462173,22,7,37,56,137,19
1.2850900253960864,3.0684485489568205,1.9339181567416133,0.7923610643578523,28,8,34,52,134,18
1.1318046123696535,3.0167776666730175,1.7831055926087287,0.7974316793700192,22,8,33,53,134,20
1.0476976260102322,3.1041880937640354,1.7659626059028968,0.8139338925513072,26,8,31,50,123,19
1.0580233740777962,2.6938899923777053,1.7689069703433633,0.7352939219249406,21,6,37,57,133,20
1.028691224148974,2.820391414324792,1.72775573473951,0.7075843831622994,23,7,36,52,131,16
1.004213191760535,2.8086029782767583,1.7189667206049863,0.627419032691285,24,7,33,54,127,21
1.1609354308285897,2.999237148371032,1.8014903911613385,0.8295659870359117,27,8,35,51,127,16
1.0754118199090932,2.7923681530524425,1.8096236670053403,0.7476438603056801,22,7,33,52,130,19
1.1290535315591632,3.1005728439777553,1.8038307467390586,0.7834832090718057,22,7,33,50,130,17
1.2641062190754477,2.9417186842411907,1.9400702802218557,0.9305484633729381,19,7,33,54,135,21
1.1489287093172922,3.1470715282035124,1.8100723121513593,0.8647487461569405,23,8,35,54,137,19
1.104820843129521,2.9487229493081797,1.8764339030329524,0.8218441245770629,25,7,34,55,141,21
1.2122925167772438,3.1845498342019,1.9970901703612003,0.9159427364739032,22,7,35,57,136,22
1.2452869968317768,2.8385348797330545,1.9670105095887782,0.875554770236278,21,7,33,52,138,19
0.9066414383637531,2.8745084537023002,1.584368311324122,0.6108743092521611,28,8,34,54,131,20
1.0779741204302953,2.995071598446114,1.8497440696979819,0.802170474081414,26,8,37,58,134,21
0.9150032180248288,2.9436471164375604,1.6933934226549168,0.5855821367803453,25,7,33,55,129,22
1.212218553578925,2.9596703073101582,1.9390628936721535,0.8044471272448476,23,7,34,53,127,19
1.1844141807139317,3.0648251214757796,1.8923112883925923,0.8449210789094612,20,7,35,55,127,20
0.8969551745993607,2.755681059988868,1.5729911458791719,0.5692420858183412,23,7,35,55,131,20
1.0023031483961384,3.0169430493726686,1.6596866817573444,0.6774851078103636,24,7,33,53,136,20
1.1821518639555735,2.976091903469288,1.9210011992492007,0.9236139930475971,23,7,33,54,132,21
1.1503212342653968,2.967280508700395,1.8370745441905627,0.7173870402451209,27,7,33,53,125,20
0.8776064666921014,2.482681578552964,1.6469716664477438,0.5675084765280267,16,7,33,55,134,22
0.8946139926931143,2.6399634717970955,1.5652940895564813,0.6609412338302444,24,7,34,52,132,18
0.9799642866093853,2.9416407857519324,1.6572714262050836,0.6798544776138302,23,7,31,51,131,20
1.1381932802840833,3.2328925493009675,1.8749170890476514,0.835970288371569,27,8,36,56,136,20
0.8415874425202692,2.8246968448070966,1.601373433006894,0.5285920788900051,23,6,35,55,122,20
1.224612693712229,2.6019210476794896,1.997307692897631,0.9453186715351604,20,6,33,54,126,21
0.8913957505837172,2.3697192169485604,1.5248523386833515,0.5405006122174041,21,7,34,53,126,19
0.9847071064284592,2.700594258216454,1.6388409802194723,0.6504289291359184,25,7,35,53,125,18
0.8732153446040494,2.6461461841871228,1.493248344694208,0.5788745847731679,24,8,33,56,133,23
1.0982956251990896,3.0077081119017204,1.70952365355445,0.750405579318171,18,7,33,55,135,22
1.1222446027596902,3.1088157300319255,1.81489580101705,0.789539913631122,23,8,36,52,129,16
1.102269268759103,3.2894759556809423,1.9674810410528258,0.928691713879784,21,8,35,53,128,18
1.1425335652171735,3.2059192244129235,1.802431185112018,0.7202363756366472,19,7,32,54,126,22
1.2127494734235378,3.3870518960638787,1.9955976918015785,0.92783587603424,23,7,33,51,128,18
1.2454138311346146,3.2003053281719565,1.9440804943340906,0.8989292413997858,28,8,32,51,122,19
1.2625445611830954,3.1186412735405877,1.9519989717847208,0.8388481522618154,24,8,35,54,130,19
1.021151763272515,3.0234140149657796,1.703320970818659,0.7289575886302255,23,8,30,50,131,20
1.0890378010554065,3.164086700416502,1.7714523847271857,0.8019713445305603,22,7,36,53,135,17
1.1724074900216241,3.249537566097254,1.878319793735026,0.8499773334249768,27,8,33,50,129,17
0.9791684681921795,2.7606148362629694,1.7691521668628756,0.658893022607214,23,6,36,57,135,21
1.2156776347649179,3.09261923850286,1.9449468911962484,0.9308712256655136,23,7,32,51,136,19
0.9321065374324546,2.9458603452742596,1.6249428088678544,0.6971762627420515,21,8,33,51,138,18
0.9982875709492853,2.9988625599686043,1.6919788805420177,0.690855657558885,26,7,32,50,133,18
1.1559543922847997,3.238032739912024,1.8924274161527772,0.8585212183915596,24,7,38,56,136,18
1.2102412475657736,3.092922888334213,1.9730506615727035,0.860444018147914,23,7,31,52,135,21
1.1416180809863246,3.0103540495040666,1.8817200815768143,0.8103350301342503,21,7,34,53,142,19
0.9325925420662544,2.760888853237375,1.6142539190736533,0.6777451155383551,20,8,32,54,137,22
1.129990153954887,3.148846373284324,1.8212264507499079,0.8161718325061652,21,8,34,52,138,18
0.8610917023054256,2.783161537415207,1.6186606735377436,0.5281209191968067,23,7,35,55,137,20
1.1634235211677821,3.001235250178984,1.87708962174757,0.7600547856809435,24,7,31,53,137,22
1.0282063225418505,3.004931274424196,1.792743714950241,0.7764341378299452,23,7,35,53,141,18
1.1265846922281857,2.927465974715699,1.7596420750571244,0.7642687539604502,22,7,34,52,142,18
1.160591864413925,3.2904325940826538,1.9646026351650023,0.8608949046598275,27,8,36,53,139,17
1.0770368762289713,2.829520824371362,1.8546125538416065,0.7366573194363492,21,7,38,58,139,20
1.103651992926495,2.927523499133126,1.8036571660194494,0.8082152714513848,24,7,33,53,139,20
1.0027145498445074,2.533819377634007,1.7546808815383108,0.767204850958639,22,7,33,52,142,19
1.0804411317030387,3.19392918126221,1.8336831408535552,0.8388859461596113,23,7,33,52,138,19
1.1583369335420757,3.1831292449511306,1.8635096975569772,0.8018561854246955,27,8,37,57,142,20
1.0263241352083021,2.9313645807106883,1.779000773547885,0.7012200282755664,23,7,36,58,140,22
1.137231566387553,2.729269452958924,1.8032520633118898,0.8254811115948915,17,7,33,54,141,21
0.9984940080373897,2.5974989666467203,1.70838311594434,0.7227299360400423,24,7,34,53,136,19
1.0185521029775766,3.1104736369740236,1.7388724751208502,0.6561791072943804,19,7,34,54,134,20
1.2617086123387102,3.2738367724171034,2.040001123067066,0.9347789196060527,25,8,35,53,139,18
1.1150080807669747,2.922867527673512,1.8168374424997347,0.7996333869978052,24,7,36,56,142,20
1.0777822481709076,3.031984636198577,1.8269676646347288,0.7709353297226287,20,7,34,50,143,16
1.0505328369721723,3.1344775564759626,1.8249142202607083,0.7489855452472172,25,8,33,52,140,19
1.0553685323216055,2.5634411839167273,1.825542002246963,0.683412063353811,24,7,33,53,146,20
1.1215581212106844,3.1537285675103366,1.80388430614635,0.7967598623136807,28,8,36,55,147,19
0.822902898588328,2.8980024115309857,1.5949290617775218,0.5272650445861886,24,7,36,56,147,20
1.139236434411651,3.148627556566101,1.9424113799372411,0.8315500096828623,23,7,33,54,149,21
0.9772035211248773,2.9204434924664,1.6991447841669736,0.628285139981901,26,6,33,51,151,18
1.083153525150404,2.704722213936799,1.8254246328073829,0.7614443055549474,25,7,36,57,160,21
0.9710003777617463,2.9384061175213567,1.7085799893179905,0.6654941211657173,21,7,34,53,148,19
1.1159180978744083,2.885931559005978,1.8586638821538377,0.7462416484022019,24,6,37,55,149,18
1.1075952719839521,3.0073846605806684,1.7830435861342444,0.7427739818018445,26,8,37,57,149,20
0.8138160864809663,2.4860798736596097,1.6293779363385432,0.5928540886947057,23,7,36,56,146,20
1.0749174067385214,3.082779947614398,1.86094444182377,0.7180508558251942,17,7,34,54,141,20
1.1090234575323246,3.0845695748234983,1.9188601908660918,0.7952930831015923,27,8,33,51,135,18
1.095593629184682,3.061368035020933,1.825416001163773,0.8376857382437881,20,8,36,51,131,15
1.016985317166973,3.0311833263714436,1.7693292279684059,0.7924754599784793,20,7,36,56,133,20
1.070490296551823,3.2319803946928096,1.8405297953949702,0.7671313776781656,23,7,36,57,136,21
1.0384250293210189,3.106321620224432,1.736003001192239,0.6659615519744527,24,7,31,52,134,21
1.2141580373666954,3.0743459332236567,1.912048442668487,0.8330282702162406,26,8,36,53,135,17
1.010373877861416,3.0477803496090337,1.7807094602547595,0.8075206388813044,25,7,36,54,136,18
1.0137431946917492,2.9226701142545064,1.720538901227469,0.7339064102333119,23,8,35,54,140,19
0.9815796660726712,3.012160789579745,1.759866977017302,0.7097196923649287,26,7,33,53,137,20
1.1404044197148655,3.018643636959503,1.839892482868576,0.806626718091662,24,7,34,56,136,22
1.0932001764820065,3.060780992421285,1.7885524691125532,0.7901526479161686,27,8,34,52,130,18
0.9488659838731204,2.6141036765060424,1.6836058507700378,0.6856788358994782,22,6,39,56,139,17
0.9769271331241522,2.723345784020859,1.7365499304460306,0.7021667106624804,22,6,32,54,139,22
1.1377226499754516,2.879562220645289,1.8099558119974906,0.7988540732308345,25,8,34,54,136,20
1.0668477502067533,2.765188120683966,1.773265566030358,0.7457679630251507,25,7,33,50,132,17
1.0592066280634764,3.0983916359472987,1.7694938512247398,0.773114248922682,24,8,36,58,130,22
1.1958209198899012,3.0160650363991355,1.92377097328368,0.8567483826992238,22,7,36,56,132,20
1.1679002447579916,2.960306393170794,1.848019852739157,0.7767237564770577,23,8,33,54,127,21
1.1005458285561056,2.8231735546887142,1.7208140786218973,0.7887332192911416,20,7,32,53,126,21
1.1401190671952026,3.031292330287248,1.7862946285490249,0.8191694599016845,19,7,37,54,128,17
1.193558157759758,3.209584143676005,1.8234273409506416,0.8076821503115887,22,7,34,55,132,21
1.094281463554104,3.1940652834110326,1.8342786782958684,0.8189444336301883,23,7,34,53,129,19
1.258674762636575,3.0949280950100766,1.9513608035455374,0.8849721074172328,26,8,34,53,126,19
1.0477903480573914,2.8436023072595167,1.7818825964353162,0.7216203929012752,23,7,37,54,127,17
0.8710758678428041,2.689650813873418,1.543560952701518,0.5674122716493839,23,7,34,52,125,18
1.09655612369038,3.012295297729228,1.7093759058324005,0.7521116449769739,17,8,32,52,126,20
1.1862570594942143,3.183301423249577,1.887385284441565,0.8514366721393967,24,8,35,54,129,19
1.1608009147765082,2.6900190621343327,1.8142326389062875,0.76509643690789,19,7,33,52,125,19
1.0441632683467579,2.8226193929050756,1.6683587901012014,0.6862512570716279,20,7,35,55,131,20
1.101054280475423,2.8847586080670045,1.7660446277278972,0.8162470244333178,25,7,34,52,129,18
1.1445181686519024,3.1822281622372075,1.8113819312039874,0.8586564764756717,22,7,34,56,135,22
1.2406649093744055,3.109594910673625,1.9045571951339646,0.8798995113606893,24,7,34,54,129,20
1.1992316176503257,2.831547504355267,1.8715050747485116,0.8713581487773318,20,7,36,58,132,22
1.0552946881426053,2.940822970384949,1.6846368519564165,0.8196937802864609,28,8,31,52,122,21
1.0811757582409753,2.935790868680866,1.7760523102981263,0.845705973127721,22,7,36,54,134,18
1.1735892297588197,3.1154595434972787,1.8202414005376606,0.8755088776028743,23,6,35,54,129,19
1.1995676705838603,2.975625136018288,1.8819346971564468,0.7964416341221867,22,7,31,51,131,20
0.9757902451986143,2.8852743559424443,1.6140486204280324,0.6870765727568051,25,6,33,53,133,20
1.038569953552865,3.0219015639224076,1.7622954781565077,0.8311086222067,25,8,35,50,131,15
1.141474936972018,2.933861813933062,1.7832119370148023,0.8379277325577135,24,8,35,53,132,18
1.280238968153637,3.1361042711443847,1.9690751869917897,0.9000134982998478,25,8,34,56,129,22
1.1950965346654876,3.049920885316875,1.824338693416197,0.8792209358927956,26,8,35,54,125,19
1.0608586145350574,2.9903272545912736,1.6793972739752974,0.8255873710031886,21,7,34,57,127,23
0.9516795242268253,2.973431401820619,1.6438113462538457,0.6886486070139115,24,7,31,51,126,20
1.2537142839642161,3.0769197665079346,1.912782899025547,0.8801681530909368,22,6,32,51,122,19
1.184285933075632,3.058184893776062,1.8628816367941359,0.861493804272786,24,8,35,53,127,18
0.8863503987510251,2.762941096823445,1.5225170800247314,0.6299292329310052,25,7,28,50,123,22
0.9475098285541123,2.8939984248340798,1.6076450206443638,0.6294685655292311,25,7,30,49,127,19
1.2555969502599271,3.207886755587864,1.9536818526992898,0.9204958804529044,23,8,32,53,121,21
1.217999476714925,2.6294447930035343,1.8867543427399243,0.9446386839680154,18,6,38,57,128,19
0.763367320276471,2.7707187093544494,1.8343827543825162,0.8131382140641862,15,7,33,54,129,21
0.8950711846907056,2.761888825572052,1.5618641172974037,0.646636107113673,23,7,37,54,129,17
1.1827485052572024,3.181403733910355,1.9146650330443078,0.9078487048431727,22,8,35,56,123,21
1.20790892194051,2.9578989554031105,1.808864382095186,0.8320139306608505,20,6,30,55,126,25
1.1622752176249291,2.546845945187748,1.7168390667751239,0.8550711548118501,22,7,33,50,122,17
0.6590276330339582,2.319883164667073,1.2279502574354517,0.30820941831940674,26,8,32,51,125,19
0.9434922383906379,2.7262056268370833,1.6179282905243104,0.6878517728676196,18,6,33,53,126,20
1.1989119748253125,2.702339813649271,1.7762791567092697,0.8472426907522028,19,7,30,52,118,22
1.1888711768234088,2.8853929613401057,1.7702890465758805,0.8310029959955617,23,7,32,52,118,20
1.217968011269309,3.16945618906161,1.8210375533948895,0.8711015880459891,19,8,35,56,122,21
1.2155374841736057,3.049800894344494,1.8666718879036317,0.9100903612502853,25,8,31,58,125,27
1.0485283065048407,2.775152523323397,1.6537112858411476,0.7243175925719388,23,7,31,54,120,23
1.1014761591863995,2.875635161272284,1.8204783380448673,0.8037732015858462,24,8,33,55,122,22
1.0887030610204358,2.833468024301717,1.7445283174071153,0.736013785181663,19,7,33,56,127,23
1.150683198620958,2.539434363904684,1.8662304096948157,0.8635738451535068,23,7,30,52,130,22
0.9886629583239783,2.9253010870582816,1.6554627988761856,0.7242984948228062,26,8,29,53,132,24
1.0892274295671822,3.0831067922011886,1.7714548403383135,0.8823020074434746,18,8,35,53,139,18
1.1848267894424684,3.0917147648662304,1.9049663583513903,0.9175308892162664,26,7,31,52,131,21
0.9746439767956998,2.656542505248612,1.5928106789930438,0.5991159186171107,22,6,32,54,135,22
1.0628835605236029,2.814564668341756,1.6201438022391101,0.7295785148329614,22,7,33,55,140,22
1.027870455542705,2.9266075272150935,1.73808933995752,0.8623802714212226,22,8,35,55,139,20
0.725221270550189,2.909811522010104,1.4436622913738562,0.5488068726882769,24,8,32,54,143,22
1.277361877503183,3.073156714303617,1.8545586055980727,0.8794043361715828,24,7,34,52,136,18
0.8387685519961441,2.827921169571245,1.8370973352226216,0.6731034916157025,23,7,34,52,142,18
1.0913707751122348,3.021379797422491,1.7908453139711114,0.8078206892832394,26,8,34,53,137,19
1.092451404192766,3.0479963520868134,1.7656884696814963,0.8090328353962466,24,8,36,55,136,19
1.0156404123175091,3.1531740317319166,1.7587669003660062,0.8692376989811199,23,7,33,60,143,27
1.0924443369981665,2.8733825012210077,1.9114358201362325,0.8735440059343498,21,6,32,52,139,20
1.1737717011361029,2.8616111884289186,1.8456882218323334,0.829069671698115,21,7,34,53,142,19
1.1196951419261876,3.1040735440730622,1.7750449874496719,0.8049265004784897,19,8,34,51,143,17
1.038957676430519,3.0619490076389377,1.708473684551665,0.8336976679484291,26,8,32,54,138,22
0.876135081408487,2.8952395411570895,1.625750835569491,0.6729825842570278,24,7,35,56,142,21
1.0176471396677333,3.037686161402996,1.711590599187992,0.7399562791413206,19,7,36,56,141,20
1.226344652386641,2.71257453779274,1.9778898803799634,0.9002563912656001,24,7,34,53,139,19
1.0388299767221323,2.991512000517388,1.715763615156927,0.7799150755621832,24,7,36,52,132,16
0.9515164925164954,3.0187906059573644,1.676062227955363,0.742920888865831,24,8,34,51,136,17
0.9273142277982904,3.0413040870840176,1.6394284946993762,0.6672780372742524,24,7,34,55,141,21
1.0247059918890622,2.9463206674304403,1.737832189102723,0.7351211220646423,17,6,31,50,133,19
1.0403989552833286,2.8290107436709,1.778387070723816,0.7249196643008357,24,6,35,55,139,20
1.0997427355902278,3.1590046682739574,1.770260475871027,0.826995553222242,26,8,31,54,139,23
0.9622388728916349,3.0082081392732625,1.6336311693443224,0.7244928789531139,26,7,34,55,142,21
1.0748214656956576,3.183394479784084,1.743929963651671,0.7692408698536535,26,8,36,55,139,19
0.9177311205092675,3.0680044037601175,1.6103739563245387,0.6439434169744515,23,7,35,54,142,19
1.1960823270644587,3.050396561340023,1.930816941129997,0.8695305016707436,25,7,33,53,140,20
1.1149092616030756,3.0882201322883156,1.7738685017733067,0.826806639397438,27,8,35,55,133,20
1.081522192974766,3.1421466332771293,1.7405653757253539,0.7936994580789146,24,8,37,56,138,19
1.0021370112074568,3.085187413268453,1.7106262006788193,0.7574732645496973,25,7,32,53,139,21
0.968718667989724,3.084374319083579,1.6373758197518553,0.6910818519394668,20,7,36,56,137,20
1.2324859162348125,3.1071684929564674,1.886640065078213,0.8813389275894092,24,8,33,55,135,22
1.1745021574346906,3.176455467934857,1.8276519825349153,0.8636175333785697,24,8,33,54,131,21
1.0235627899277935,3.0344323220294775,1.6618317780056096,0.7502239230983021,23,7,34,57,136,23
1.044598544061638,2.9824025005663928,1.7124655070948072,0.7486976446651857,21,8,32,52,139,20
0.8929503004434255,3.0763423065222897,1.6750946723440978,0.6296220436062363,28,7,32,51,129,19
1.1987161708805987,2.965516475885843,1.8724600290935836,0.8421446959335299,26,6,31,51,130,20
1.109266287311123,2.738633742445252,1.8741814321625814,0.87668804167479,25,7,37,53,136,16
1.0478207469413983,3.0787104153032696,1.7032258875948303,0.7579101418108158,23,7,33,53,135,20
1.0840242584069533,2.950647208474808,1.7760321661167628,0.8091610185730831,22,7,32,52,135,20
0.8692248663908871,2.793765345343577,1.584107133573881,0.623919711171049,25,7,30,51,126,21
1.230633267354131,3.1891414879259328,1.9506366116369551,0.8669562190676933,26,7,38,58,136,20
1.134975208952595,3.089150503942399,1.8038596527863717,0.7885374222758589,26,8,33,54,137,21
1.0346966741305152,3.0394870706769397,1.7486079912886254,0.7734918221006919,24,7,36,55,137,19
0.9859237133380949,2.8768904676383302,1.6756678789885773,0.7430998414986976,25,7,33,53,133,20
1.0437056735648742,3.2355891124944995,1.73553015929907,0.8472773776777787,26,8,34,56,137,22
1.0062593565965035,3.1121220711162927,1.7210356137609923,0.7143123185212503,26,8,33,54,141,21
0.1691798767972128,2.412634463349299,1.5814562914618142,0.44514928008308097,14,6,34,54,147,20
1.1134288988520198,3.1433346689833463,1.8152161819930264,0.851313750022308,26,8,34,55,154,21
0.9735921000357082,2.8614944589350513,1.6938667981223874,0.740614853006994,25,7,36,56,163,20
1.0846849940216712,3.2262718918625004,1.8046017378676722,0.8673327660303897,20,8,34,53,165,19
0.9964668186504934,3.1194900785482753,1.7332211466805627,0.7835721262132538,26,8,34,56,163,22
1.030857436643217,3.125462663701706,1.8398413724044809,0.8240684937228964,28,8,36,56,165,20
1.1891995882751107,3.2042936942054276,1.9320449690771788,0.8451045678643331,23,8,38,55,156,17
1.2714905725367238,2.954634074488991,2.0147781500447617,0.9449102181354843,21,7,36,55,156,19
0.9197388419650969,2.9347471098012807,1.6705604415307476,0.7213878709277406,24,8,31,57,149,26
0.8719781052205893,2.995182300190728,1.3627547147390966,0.779360765079008,25,7,22,52,149,30
1.0902043184346928,2.834813018284846,1.74479651986347,0.7800566045690324,23,6,34,56,153,22
1.1423641215364526,3.2749671351551544,1.4991831816008534,0.9671033075621998,27,7,17,52,145,35
1.144937359796473,3.0970801348108656,1.9167827723900415,0.8249206728351841,28,8,35,52,139,17
1.0780048888344664,3.1067877708266654,1.8237527574021712,0.8408193342392518,23,8,35,55,145,20
0.9905247895344593,2.9251131273974793,1.8148138503890694,0.803518518752987,25,7,30,53,146,23
1.4334522748315213,3.636293238412244,2.1592266507843676,1.1821303497607396,25,8,35,52,146,17
0.8633600914654158,2.7415064491583836,1.602161972221275,0.6107284897694382,24,6,33,53,143,20
1.0223400214821734,2.7186588923047865,1.793310275697812,0.7061863300660224,21,7,34,55,146,21
1.0212786362569204,2.990891730896518,1.6967641421300703,0.7202568920136723,27,8,36,56,147,20
1.0751688215494792,3.2133620147102775,1.758885570802619,0.7953112252551832,23,8,38,56,152,18
1.0371595230977677,3.1626410958116296,1.8053000903275254,0.8059117707209149,22,8,34,53,141,19
0.9274944187799745,2.838345965177256,1.6890971569712918,0.6024518668986305,24,6,36,53,138,17
1.0394456440367605,2.902111790092437,1.7900883497575997,0.7814734841411382,25,7,33,52,134,19
1.002814622885264,3.059657783956151,1.7315090522492669,0.7708890925478036,25,8,34,53,130,19
0.9709047560087679,2.961867351471602,1.6529289624630172,0.7276450775619009,19,7,34,58,136,24
1.1818729752514223,3.0653097351432206,1.8429813233117662,0.7953555886251434,26,8,37,56,135,19
1.1797360352563209,2.8523354022746457,1.8158856236652692,0.7393842444369838,22,7,29,52,131,23
1.1182426658635203,3.1120943320446033,1.768263073412705,0.7938487826861794,23,8,35,56,133,21
1.0206550569033257,2.8583016014687996,1.6360780559191852,0.6897547149062264,20,7,36,56,140,20
0.7430741557413392,2.7820406584657,1.4235743875892246,0.4543805555492938,22,8,31,52,136,21
1.208595138780317,2.954326266921462,1.8477190543885085,0.8204521998589206,20,8,36,56,134,20
1.2047562677044203,3.0724966769823796,1.9054653287775398,0.8199387201603304,28,8,38,58,134,20
0.9933972710954486,2.7633987460320606,1.680930093376888,0.6808814164795116,22,6,38,57,134,19
0.8826894467021638,2.6872200805529616,1.493916848023107,0.5822594547053268,24,7,31,50,131,19
0.9874366002981333,2.700161843634981,1.6191206584966447,0.6267620800782073,19,7,32,54,131,22
1.058523036208899,2.8620712560558332,1.6265222816574165,0.7261701975182303,23,8,33,52,125,19
1.0440545066043214,3.0144506586336615,1.686520211096866,0.7195587924206649,21,6,36,56,127,20
1.076398095402058,3.0065304205945687,1.7738584986112649,0.72355072898141,23,7,32,50,129,18
1.2917581393216921,2.906689860524753,1.9089340044408551,0.8953772910101635,23,7,34,55,126,21
1.4090354944439283,3.236394807264409,2.0017668142331813,1.0223482912734703,21,7,35,56,126,21
1.1058596364267108,2.88923589714903,1.7251633618477131,0.7502941507888408,20,7,32,55,129,23
1.0568515243730423,2.826769252546684,1.7495578379910195,0.779878469006072,22,6,37,56,140,19
1.1717391740247967,3.014819665072122,1.8549535562320592,0.8495395788539144,22,7,32,51,131,19
0.9687389634437402,2.8372958336125134,1.6790059415283618,0.6240763155145667,27,8,37,56,131,19
1.0753137658149337,2.906223699668819,1.7915561049659259,0.7000430375828927,18,8,35,55,134,20
0.8355019563146054,2.656189202228811,1.4886409979505806,0.5599573467414556,24,7,35,53,135,18
0.9790768374059582,2.9745321387209236,1.612659818711498,0.6811034851052409,17,6,33,53,137,20
1.1421871373428931,3.3382994574339744,1.9266135077412085,0.8465915966877438,18,8,33,54,128,21
1.236275007677838,3.0493589074297613,1.9340770366510398,0.9076633734854339,19,7,39,58,137,19
1.1378884513528993,3.006749397660199,1.8370748706773012,0.7708264555440427,23,7,36,56,138,20
1.0618376358109418,2.8835083406170927,1.7297139205323049,0.7459901671826635,21,7,35,54,139,19
0.9745878567578216,2.9953533008501694,1.68881157015988,0.6945500155905138,26,7,36,58,140,22
1.1542696226210776,3.239697901489845,1.8430141632003703,0.8138129939424534,24,8,36,57,132,21
1.2174762419622174,2.894235152771156,1.8634051270024425,0.8397157168741582,18,8,31,52,134,21
1.1325811010972218,2.80827784223573,1.7999314127523032,0.7651317445604797,25,7,34,52,135,18
0.9587546208884679,2.984898135748737,1.656019384050759,0.6949959980205711,28,8,33,55,133,22
1.11213988775254,3.215018331277706,1.7134565470311207,0.7741599955561448,21,7,37,55,142,18
0.9504043813960051,2.992384849952912,1.6387154373788047,0.5972486706510743,25,7,33,55,133,22
1.2010818750976877,2.937115365032774,1.8815821768667966,0.8320768821315858,20,7,34,53,135,19
0.8997913337064717,2.8373143993679255,1.5651918879566475,0.5752459400310228,25,8,32,52,134,20
1.0907934653008438,3.081631926051511,1.6809169272593463,0.7303820038697517,26,8,35,52,133,17
0.9555565495295827,2.848567350207123,1.620234808815973,0.6484703008466999,18,7,35,59,145,24
1.0807766472960703,2.979239786069905,1.799806256733707,0.8013768461439048,21,7,34,52,144,18
0.9231834882374396,3.0789579233541984,1.6073249796815852,0.6248287076096228,23,7,33,54,144,21
1.0589316028361473,3.3680318498840127,1.7718464952351807,0.8074381276666367,23,7,31,53,142,22
1.1397057130515664,3.2867614567183034,1.8927695646027174,0.8549712476187654,25,7,32,56,138,24
1.2288235235731022,3.0621422566114234,1.886791145662316,0.7899384380708309,24,8,37,57,134,20
1.002484345830376,2.837522167543689,1.6502900782729788,0.7003211903513322,21,6,31,55,138,24
0.8875704043524719,2.9612289942984287,1.5095577133135831,0.5388363100071503,24,7,33,54,138,21
1.0918291152027542,3.234993964459136,1.7785251508310609,0.7642925226928421,25,8,32,52,130,20
0.9182389284730093,2.716654678397444,1.6911119557507348,0.5456135201485722,23,6,36,56,132,20
1.0271443917885978,2.873705974682633,1.699331204261327,0.6759804972985037,23,7,33,54,136,21
0.9241299301966295,2.9590877173064474,1.6640310201704058,0.7247114890092132,23,6,36,54,140,18
1.046576851671865,3.042107456608008,1.844713109388829,0.7385254973950148,22,7,33,54,139,21
1.2218311453355892,3.1035146206344364,1.9497631219414238,0.8728386386402351,26,8,33,52,129,19
1.0001956105585614,2.5297575944167763,1.670764582230804,0.6247678198776541,19,6,36,61,141,25
1.0141534557749137,3.003144835528241,1.7508773767051127,0.6694237375990802,27,8,34,54,141,20
1.0938880577895576,3.0871726186078132,1.7714822522518094,0.7881342894563721,20,8,31,51,139,20
1.103287511207179,3.0577101876767014,1.832018185830845,0.8308868706599815,23,7,35,54,143,19
1.0101979824989384,2.959565955756922,1.6271317185140675,0.636268601217006,17,7,32,55,143,23
1.0533878629037206,2.868894128052795,1.7122049639434507,0.681455827634476,26,6,38,56,143,18
0.9007624977645936,2.8422962083937287,1.609512325339292,0.5888507094665205,23,7,33,50,142,17
1.0840237407604656,2.899314049187554,1.7425545043563946,0.770327109566661,23,7,38,55,151,17
0.9276681931903112,3.0785850276373514,1.65074099148574,0.7060321437337711,20,7,35,55,150,20
0.9959519090115996,3.0753181581195843,1.7825060928284757,0.7062645208185797,27,7,35,58,139,23
1.2788819847765909,3.091910742219944,1.970287874176281,0.8817839855566032,24,7,35,56,142,21
0.9238153352442636,2.7899729304529073,1.6068124170694076,0.532030381922243,22,7,28,74,137,46
1.0556921764084626,2.986254122708162,1.5157283185169201,0.5913317605166608,23,7,32,54,141,22
1.0622726724850715,2.9591386410996376,1.7995962826199614,0.8072214120378275,26,8,34,55,136,21
1.2498037134820437,3.223103716059053,1.9498400150402984,0.9229648438762288,23,8,34,53,131,19
1.1941946699926433,2.7184170844165507,1.856294677180119,0.8574409693361367,24,7,35,53,133,18
1.0704049601701244,3.0092386693120474,1.7480820358983038,0.7617972603601393,25,7,36,54,135,18
1.1366193451545477,3.1504208722555007,1.8180246489889291,0.828715590472078,22,7,31,51,136,20
1.0277904852372943,3.1567540556958953,1.7780085540211945,0.7507411338358299,21,8,33,52,127,19
1.2299342468230758,3.0489429363086717,1.8941296272809072,0.8882669532562691,21,7,35,56,140,21
0.8776569304551813,2.795022046667935,1.538161895062455,0.5972707725108101,22,7,33,55,140,22
1.0736667768710335,2.9867549848873045,1.760340921791262,0.8178056017122178,23,8,33,50,140,17
1.0315809610776272,2.9578861128965466,1.7560390626924673,0.6857839116702431,22,7,33,53,138,20
1.2004897326251522,2.9079642635413245,1.9191588681911864,0.8666056299970804,27,7,33,54,133,21
1.0646187887404501,2.8938712545965615,1.800319972656512,0.751174571350758,22,7,36,57,137,21
0.9708569942410621,2.98973206836171,1.7117332774546337,0.7342962029330808,23,7,33,55,144,22
0.9919618634173286,3.048206032613205,1.7023271513574716,0.7123680367768822,24,6,35,55,140,20
1.021584389343905,2.7276463290598416,1.7154679248560156,0.6357276615192058,24,7,35,52,130,17
1.1698346639798247,3.0253587961808135,1.857083193914382,0.8508622648523929,27,8,37,58,136,21
0.9406256933922157,2.9258703584847074,1.6354778153423633,0.6794961519556116,24,7,36,58,137,22
0.9628172526669839,3.043435805215335,1.6218314504247473,0.69079523287756,23,7,33,54,139,21
1.2103073505744304,3.1298783724097143,1.8668763017928005,0.8091381730998835,25,7,35,56,134,21
1.2569729145895852,3.1216760411574436,1.9395444929105894,0.8759301418507579,26,8,33,53,133,20
1.0583297646450682,2.7948562646033075,1.688530796229537,0.7861190108160206,23,6,35,56,136,21
1.1633150688148992,3.243887060206908,1.7944950223011407,0.8479771975138899,25,7,31,55,138,24
1.1285344171207412,3.1357204416814755,1.7841234544419176,0.7828085607199823,23,7,35,55,137,20
0.9987919711328384,2.6299298754644185,1.6399229811852114,0.6431450947049496,22,7,35,54,133,19
1.1487884871314926,3.08716970846763,1.73474922376908,0.812043950892895,20,8,37,53,135,16
1.118748764883497,3.155392755995644,1.781527140052253,0.8301735496458118,25,7,37,59,135,22
0.9738082104148452,2.9326709489770604,1.6347788421556764,0.6518191711304091,21,7,34,52,129,18
1.280396702170171,2.933253612531757,1.9308537944429478,0.8700501111703907,26,7,34,55,129,21
1.169736355990358,3.03808669861632,1.8340488078456736,0.8234796675656519,26,8,35,54,132,19
1.0568128222508197,2.807696165133671,1.7025903639348845,0.7631522593364038,26,7,30,56,135,26
1.0959444550995787,3.0952519069938518,1.7510675823347264,0.7619373429564966,26,8,33,51,128,18
1.2379054157802158,3.1065611475464356,1.8547920223978434,0.826591319475042,24,7,35,52,126,17
1.1809236714180955,3.0027408383271657,1.8577588957580828,0.8455756634932158,25,7,37,58,129,21
0.7254515932631763,2.6638682415785926,1.3671317771365719,0.4581277000338799,23,7,31,53,129,22
0.9800106302590195,2.81040630192288,1.6269102643267157,0.7214010560601752,20,7,31,50,131,19
0.9648346702416455,2.951760836262531,1.6836018041001606,0.6527047959642336,27,7,33,51,125,18
1.2777417564940459,2.8699890419131124,1.9884482176735572,0.9356658357562194,15,7,38,57,133,19
1.1869851236529372,2.7995233037035496,1.7698657387792234,0.8185809699625133,21,7,32,49,128,17
1.119881410247387,2.8630431790019557,1.7568331450163293,0.8185781082009307,20,7,34,56,136,22
1.056733569725918,3.0754895775976383,1.738681211241193,0.8019153532952251,26,7,33,56,130,23
0.9197339152006208,2.922885616762154,1.568663972687662,0.6179794375970746,24,7,36,58,128,22
1.2437463320654445,2.7994212069365005,1.911661671829307,0.8438906134315984,17,7,33,53,132,20
1.0142316389454995,2.847328290246047,1.7196093860908706,0.6863343489816806,22,7,34,55,131,21
1.0963817114740155,2.9549766914001294,1.6672695563259032,0.7791042938615509,25,8,33,53,127,20
1.1439316156070534,3.126773753143593,1.7928527937804815,0.8096413929704265,23,7,33,56,129,23
1.278132863582028,3.083153543482585,1.9480931971205568,0.9070700874124179,23,7,34,53,126,19
1.2913864883313946,3.1145903879692076,1.9231404863755241,0.8994138975167514,22,7,31,52,126,21
1.22862371577676,3.096118224487734,1.8118953479661286,0.8587109778719706,21,7,37,55,129,18
1.1855723700667156,3.0858461040100127,1.8320832063220935,0.8794926386777326,21,8,35,53,131,18
1.2891757113628277,3.1611303314599537,1.9125782759887253,0.9731941670793818,21,7,37,59,133,22
1.2456295614600132,2.9071677723144753,1.8560823207036796,0.8666238225714233,21,7,32,52,133,20
1.1039710656491595,3.0323857428779855,1.7697451853990385,0.8638048546126729,24,7,38,59,140,21
1.0784643169302321,3.145572120089844,1.7676067585578559,0.03299404664917738,21,8,34,58,136,24
1.0966207830681942,3.2108144631597346,1.9264095904024552,0.9139443242771846,16,7,35,54,134,19
1.0795484575074452,2.8112163163898742,1.7665874971127016,0.6549351165263946,25,7,33,55,127,22
1.048934903372102,2.814187916880935,1.7474677934758076,0.8158581698818955,24,7,35,55,132,20
1.0243939371018547,2.717636711233181,1.6001403450935618,0.6777333873370786,25,8,32,49,131,17
1.0791888377856829,3.178627079246943,1.7156605490082684,0.61044741561878,23,7,30,51,127,21
1.1013654570462796,2.865011985806102,1.6447784788149753,0.6108601119481473,26,8,32,51,124,19
1.1703008324369062,2.96020241679897,1.7894482057162016,0.8112862555567639,20,7,33,57,133,24
0.9989656541638126,2.6576199937484954,1.5950147157861811,0.7020864775651354,19,7,34,53,126,19
0.6875860294060341,2.589396002370684,1.3082910763346616,0.3229801990565797,23,7,34,55,126,21
1.1828467217640173,3.11254277331879,1.8729183082386576,0.8844352232707615,26,8,33,57,123,24
1.2166582409667288,3.1384654657517457,1.8753744828805103,0.9121966441460211,23,7,36,57,125,21
1.3129232952099579,2.8534981919422293,1.8950798421269732,0.903609854122913,22,7,33,56,124,23
1.1337014255649531,2.8742581617035876,1.7316474534545994,0.7474581244425128,21,7,30,51,120,21
1.102545995283529,2.9976797771777424,1.7208739679697098,0.8290631391397869,17,7,35,52,128,17
1.0312542872755908,3.0541459288284067,1.696219798854033,0.7532489825231876,23,7,33,52,131,19
1.1691320452603657,2.9808300062401156,1.8478305617411133,0.8840209336946476,22,7,31,53,129,22
1.1781671064465749,3.096501840330918,1.7655537412700808,0.7791053480566223,26,7,32,54,131,22
1.0953255617376412,2.953171556488792,1.8136761589859463,0.7719582553306291,24,7,35,56,134,21
1.0572002296626124,2.7846432890262407,1.6841564036412082,0.7179974112265255,16,7,31,50,137,19
0.9440060516043427,2.8788963169972908,1.5741082909280035,0.6523537747654881,23,7,34,56,144,22
1.138498435121202,3.158061356610875,1.8378261532360882,0.8839689538660538,22,8,32,58,130,26
1.3068591923920352,2.8491197488692652,1.8894750956105557,0.8252955547816727,21,7,37,59,135,22
1.050877210664813,2.970180768570724,1.7209256767859726,0.8114091156934499,23,7,30,53,132,23
1.1019450261045285,2.918139016183602,1.7639186896882273,0.747890859749934,21,7,34,51,135,17
1.103475609918684,3.129401210820902,1.8186528088974816,0.817030432431368,25,8,34,55,131,21
1.2702491982960114,3.103560699899666,1.91613459763939,0.9528576338070132,23,7,37,53,131,16
1.1828599435388092,2.875785281101021,1.8223386870003682,0.739601535652282,26,7,31,53,134,22
1.0263331273252294,2.92363227740534,1.7168749721706376,0.7736366196371288,26,7,35,53,134,18
1.0171063930820365,2.7197285428176396,1.668003314369759,0.7504775043229784,24,8,32,53,132,21
1.1214943105704505,3.1383969392992452,1.7519698319873809,0.8080123786835228,21,8,37,55,135,18
1.3203569781897828,3.0689626447645013,1.873156560350905,0.9034283994284629,25,7,33,57,131,24
0.9659390331711727,2.7637841989271807,1.5857196473755968,0.577569492869416,24,7,33,52,136,19
1.1151797934782628,3.0216852670684786,1.7310421638778806,0.8020468134384307,25,6,34,55,143,21
1.051114377377571,3.0583340228657017,1.7276284764175303,0.8209579487514177,21,8,35,54,144,19
1.0524108424569292,2.999489431743073,1.7546638690981458,0.7807217189531888,24,7,32,58,146,26
1.198850857139273,2.974836539687546,1.874382923108137,0.9431063471166012,25,6,33,52,140,19
1.2483721534879606,2.8627054843903053,1.880529959190036,0.891974418013693,20,7,34,52,137,18
0.19037862957619478,2.7231379685833854,1.4840225423794469,0.4751525745725368,19,7,34,52,136,18
1.0446545596247305,3.0601959456732866,1.718272576047612,0.8256242624828214,25,8,37,55,134,18
1.125063914096104,2.8896219082936163,1.8083687343357173,0.7799576397414456,21,7,33,55,130,22
1.0418093959540968,2.8258181376609746,1.6433556215414316,0.689826669799503,24,7,34,55,131,21
1.0754057400013488,2.7585559302191047,1.665869690069948,0.7456624596152097,19,7,34,54,132,20
1.1051849566435126,3.147482942546632,1.7184380102289114,0.8512782419324316,25,8,37,56,133,19
1.116750229359974,3.218415506332075,1.790571938205105,0.8208516652811786,25,8,32,53,135,21
1.2157757655889638,3.1653021958829237,1.8499085227979928,0.7418874301147924,23,7,34,53,135,19
1.0754741974986777,3.0626461300216556,1.7867352415034303,0.832207489280408,25,7,33,54,140,21
1.1093010453146415,3.1443672190680285,1.7371192243423421,0.6264856043241823,26,7,35,59,146,24
0.9986561341326365,3.0016601559693834,1.6082969745996796,0.6862053110739665,25,7,32,55,148,23
1.0384681498725619,3.055205894250545,1.7909981828142618,0.7906299982413489,26,7,35,55,143,20
1.2222441066010894,3.108194279029579,1.9508515040261671,0.8751286001638822,25,7,33,53,145,20
1.0360032087981268,3.0455731160188058,1.7112852584493758,0.7856256713154353,24,7,36,57,147,21
0.843734630853141,2.94198255825217,1.5350415857216464,0.6495719250464289,22,7,34,54,147,20
0.9871402509811416,2.996425930090792,1.7801592283684875,0.7395873208515654,25,7,38,58,148,20
1.2181876465149168,3.1517447444932154,1.8982142594480615,0.805797588424954,21,8,35,54,143,19
1.1530877450314811,3.0942817789778085,1.8083619231753523,0.8923455881930565,21,7,33,56,145,23
1.0037317140505082,3.1033866564001875,1.6965699266866916,0.718984575491345,23,8,35,51,136,16
0.8692353195586995,2.7768461161375866,1.5904090112950138,0.6157428525481843,26,6,36,55,131,19
1.181220519536423,3.060334763696078,1.94233961462872,0.9050817604292828,23,7,38,58,131,20
0.5237586364053342,2.9865708021225332,1.8146212006177114,0.7137611590549875,16,7,33,53,125,20
1.151185120780141,3.1376879993569804,1.8100935675338323,0.8430863318103674,19,7,32,53,124,21
1.2177573854000303,3.046744276527132,1.8517286409817726,0.8569274693394614,26,8,34,54,120,20
0.9568844955467921,2.8125047320277057,1.5917342810582011,0.6080972408076457,23,7,29,54,128,25
1.1114132211245127,3.0401190735141843,1.7146973363076,0.8051859758801296,22,8,34,51,133,17
0.7868503007733615,2.7290207023880377,1.4367519059431781,0.521456733354583,19,7,32,54,137,22
1.1422414077389487,3.2593483371947496,1.7200544112172207,0.8798963961972415,25,8,34,56,137,22
0.9890083794573716,2.9735491169621757,1.7037465142297625,0.7535177746138302,26,7,34,57,138,23
1.1736080921496825,2.9664744147437125,1.8363997725937564,0.8502682405657291,19,7,33,52,142,19
0.9941659456706275,2.991631419461287,1.7060752774717511,0.7769470029224064,24,7,32,55,145,23
0.9172823585749179,3.0618223204738793,1.677913306001758,0.7520079175008869,27,8,34,51,140,17
1.1118364568901051,3.2027875112459987,1.8956615435602244,0.8852453100617244,25,8,35,55,142,20
1.2575006214379367,3.0047241976165906,1.966146321369354,0.9678259220374047,24,7,34,56,137,22
1.1051523626413704,3.0423296219380056,1.8227868563797751,0.8331905290245366,25,7,36,54,143,18
0.9422729681855568,2.9242300934330085,1.579173444682618,0.6567436558607036,20,7,33,54,143,21
0.9882554440935931,3.0726471918921026,1.6886829671901782,0.7157566561508094,26,7,36,57,135,21
1.2271981572117574,3.105144144508075,1.9000636432967566,0.8588596305999758,23,8,36,55,135,19
0.9748827101700502,2.699063066325507,1.6669757726973096,0.6780302903896905,24,7,32,54,138,22
1.0856809607794158,3.0754152712578664,1.6940289461581395,0.8151443738539148,23,8,32,50,140,18
1.1221450268821749,2.837602864192225,1.781980315685193,0.8682275374447789,20,7,35,56,147,21
0.5889054537462924,3.2109657308059716,1.6155056995666186,0.6666389116380904,53,8,34,55,141,21
1.1876621921099828,3.080046317870996,1.872860240381547,0.8720070151223468,22,8,40,55,142,15
0.9070163588072924,2.467168589890802,1.5557076161103538,0.6323444124863019,22,6,32,52,144,20
0.997542629949993,2.7925317459941734,1.680871848893198,0.7668827860737648,24,7,36,54,148,18
1.0329468928063215,2.911215210345935,1.711545742879738,0.7875477057582702,25,7,33,51,147,18
0.9755902908839421,2.9236269939891377,1.680119694310651,0.6749516238066064,27,8,32,51,137,19
1.211208326660445,3.0635529573941915,1.8346548246584702,0.8154072003566257,26,8,35,55,149,20
0.9791914345007965,3.0471503547197387,1.7030954734320383,0.7178266398850826,27,8,33,53,145,20
0.901626840182511,2.8538961465423265,1.6205720697109183,0.6423875053205919,20,6,29,53,144,24
1.0452787185472787,2.8955603370888348,1.7191640427663417,0.7828537335085011,23,7,34,55,141,21
1.1273156495600856,2.6056689229435928,1.7969431734390122,0.7840072064819836,22,7,34,56,143,22
1.0683890731440542,3.088948463962736,1.7231679198126626,0.7915224294450917,22,8,34,53,140,19
1.0107114152106094,2.9638279128269343,1.717839646862561,0.7372066361113072,24,8,37,57,143,20
0.9076210813460874,3.019327611503491,1.7044806522584448,0.6940242404463742,26,8,32,53,138,21
1.1570033891162745,3.0311333246223864,1.7573828358193464,0.8229986166619002,21,8,34,54,137,20
1.088320295061599,2.836886062623332,1.7170936806800166,0.7615801223279703,26,8,30,51,136,21
1.0700854525176355,3.0445937285569364,1.7049035087897726,0.7621425505616914,28,8,32,53,141,21
1.0101158105528378,2.955475096598649,1.6626234836583058,0.7803892119489653,26,7,37,59,149,22
1.0515594955013245,3.090606089948624,1.8025392408084717,0.7988814009911087,24,7,31,51,145,20
1.1993363341007548,3.19595984218395,1.922695900931806,0.9096199174142444,27,7,35,56,149,21
1.0816561409318588,2.9085138965690343,1.7833148599757536,0.8203882915386294,25,8,33,53,148,20
1.0687822117365444,3.0741007527123467,1.7160160443839354,0.8201498230118798,25,8,34,52,153,18
1.0419489575251015,3.0653319363047387,1.7026717367631583,0.5445379514508266,19,7,34,50,148,16
1.1698915948214528,3.1939904901665845,1.8803827116515137,0.8540972179118607,24,8,37,56,148,19
1.0165856913019604,2.8806604561251374,1.7611000342440848,0.6606542570651175,24,6,33,55,152,22
1.0371692121005025,3.0254094374238942,1.752176504982796,0.7437950943128628,22,7,30,50,158,20
0.9913023050874419,2.8150016151335544,1.7016671512340464,0.749396735585405,24,8,33,54,153,21
0.9298261137713251,3.051509485461398,1.7191475863516763,0.7042559241633473,22,8,34,55,149,21
1.007913895634361,2.8193128258135554,1.7013158909540826,0.6355021394468376,28,8,33,51,146,18
1.0894596930896485,3.0969923047453483,1.7760852454116063,0.7823191799086888,28,8,37,57,151,20
1.0798597645874886,3.1328045888774723,1.7471277716131417,0.7768484705465204,26,8,37,54,152,17
0.7448546742208857,2.801052011786922,1.49908197115918,0.4465888202721775,26,6,38,56,152,18
1.052194445057903,3.133164566425495,1.8506037972193403,0.7132928407609764,26,7,32,52,146,20
1.2236649844751797,3.049811575911552,1.9051745525340364,0.8556470405760415,23,7,33,50,146,17
0.98866636062348,2.991421701294574,1.6885441180512983,0.684051231623811,25,7,35,54,153,19
0.8682458010252421,2.8712959384160817,1.5746589311166883,0.5614333801629221,23,7,34,53,156,19
1.0642052476744432,3.1138774734962555,1.785304910573633,0.7607406831998625,28,7,31,50,143,19
1.2505949093146715,3.1340001012667407,1.9539631801408066,0.878496447056833,25,8,37,58,146,21
-0.1458914546393012,2.494177653290844,1.2598594377356456,0.21324010855260833,23,6,34,56,155,22
0.8899778391402924,2.7979629881357546,1.6480633381661571,0.5590092122164718,25,7,34,55,154,21
1.056774890823854,3.1021305308200082,1.7745000766650911,0.7211485437532282,25,7,36,57,152,21
1.2334162464812262,2.9174401196161903,1.6363092049264014,1.0760289864090014,25,7,21,53,148,32
1.0341175066385708,3.021038146893422,1.7306720857737572,0.7242802710491032,22,8,35,56,150,21
1.069017725191316,3.0821220023451312,1.7776309199741303,0.7778305575530984,22,8,36,55,151,19
1.0613615307001532,3.169510654059093,1.7858167021673115,0.7315187693628666,27,8,36,58,150,22
1.0669955295160465,2.9430759183803104,1.7848218773131173,0.6919740154200185,25,8,36,56,145,20
1.07791006754816,3.0284838388310367,1.7721043877848184,0.7685459857875342,26,6,33,55,149,22
0.7170495336074711,2.9261955365183807,1.7335796045947733,0.49250296900714785,24,6,32,49,149,17
1.024963976077672,2.9298440908902252,1.7384650586879506,0.6982377261773283,28,8,34,52,151,18
1.0696000050049876,3.1057843182101115,1.7862728977245454,0.7734807118972313,25,6,37,57,153,20
1.2190808999096439,3.0972470335421427,1.8909947979739845,0.780885435485695,29,8,34,52,147,18
1.0874967121713262,3.118022873306317,1.7841181323783655,0.7961127752133514,27,8,39,58,156,19
0.9230214334744917,2.981291495246664,1.6470617873370803,0.6854315359040376,25,7,39,57,148,18
0.8248083238183928,2.745435392313712,1.6074336207020905,0.5515830701932738,23,6,37,61,146,24
1.1975641057321935,3.0784735355077544,1.8909100802802568,0.8337333919937964,20,7,34,52,137,18
1.372927321081231,3.361234424216094,2.144825283928859,0.9611573624449765,27,8,31,56,131,25
1.2311951260951948,3.0442756184198787,1.8526487094924797,0.824043314666074,26,7,32,52,125,20
0.8262784961411075,2.29525002083511,1.4391003723477114,0.5715641880793036,22,7,37,52,130,15
0.8699429096951609,2.4769095470995492,1.4703217040442316,0.5108833383296397,24,7,36,53,134,17
1.1046444216151097,2.636867052514827,1.7223086718775102,0.693914724083592,18,8,34,55,138,21
1.088448980664292,3.039958486892728,1.7302712578473076,0.7320174828009778,28,8,33,53,137,20
0.9724167292180795,3.0752788611707635,1.6419440077681202,0.6232094223132096,25,7,37,56,138,19
1.0538497165155147,3.271967027991713,1.8150854220409782,0.7404100169305543,27,7,33,53,132,20
1.2765188502775453,3.5204013099423452,2.02232287516105,0.8771050501055442,23,7,32,50,127,18
1.3074303982232727,3.456938175273923,2.0351172454751305,0.8817249082651576,23,7,35,54,129,19
0.9866695890632851,2.803372480491118,1.661464904388228,0.5048882577341913,22,6,30,56,129,26
1.0870252444575499,3.323866671561633,1.7737279669577082,0.6928063399082531,24,6,30,52,128,22
1.3171284169779125,3.637869654167239,2.0515846069892936,0.8380314816107041,23,7,34,54,128,20
1.4212061015679291,3.292306664596272,1.9481701226304633,0.8624069092496497,28,8,32,56,127,24
1.0395138158722357,2.81544017305393,1.7141244001896574,0.5986545609590647,22,7,33,55,129,22
1.0274036328102158,2.756595460969311,1.7219898542653183,0.7318597939459246,24,7,33,50,133,17
1.0954979146196533,3.0857159658850186,1.7898800615113006,0.7663942944453195,23,8,34,58,141,24
1.068162511478414,3.129918375378799,1.8554714752422332,0.8112164656883543,27,8,32,54,142,22
1.136287218962332,3.0015448674359297,1.8608704653118213,0.7859066153704467,19,6,37,58,151,21
1.1256656148330502,3.1689814930589497,1.8128148836784357,0.8182086822187725,23,6,35,57,155,22
1.1881008478669763,3.2432281121946445,1.7951998746855704,0.8048199209944447,26,7,30,56,155,26
1.113712195403139,3.198603286022305,1.8342348433154252,0.6948997465703393,17,7,34,52,144,18
1.1279963966177484,3.062795205451822,1.8060252268282837,0.6623163826571623,26,7,33,56,149,23
1.214486128241147,3.260100541924963,1.898998845932824,0.886097131575932,26,7,35,56,145,21
1.2119937642797964,3.295266823519415,1.9302375643067728,0.8499921833965087,25,8,34,55,143,21
0.08379324282608824,2.941521677152588,1.4484890545590514,0.15977189617179888,21,6,29,57,153,28
1.127941358629321,3.27119493257044,1.8366132934474164,0.8551672722483802,24,7,32,57,155,25
1.0129419429679456,3.032054161667955,1.7840045241536089,0.7321725810185843,27,7,28,52,155,24
1.0994093889668624,2.932766666954228,1.8549836475084935,0.8301567867351746,23,6,35,52,156,17
1.181705385099456,3.328088676605304,1.8494591587885407,0.7229931794357566,20,7,35,54,154,19
1.2762584085433295,3.183022452042416,2.027817077690087,0.8502694475337962,25,7,32,55,155,23
1.1569655355840316,3.011238821832327,1.9100904992184433,0.8189063786382356,26,7,34,53,151,19
1.103581213851292,3.235385037947786,1.8783167076182399,0.8771538340034291,27,8,38,59,154,21
1.133148705639746,3.1197920819163447,1.8280942176133854,0.7932992964223021,28,7,37,57,152,20
1.103435874000488,3.4272149704516295,1.9692128496938843,0.8020815176924527,26,7,35,59,155,24
0.9695573655773047,3.1185408032569493,1.7143867007879066,0.630929198936415,24,7,35,58,154,23
1.7623305447753401,3.794365887840665,2.7985419208330313,1.5039421738396368,26,8,32,56,145,24
1.2919165761493385,3.1447882833333307,1.9633926012279987,0.8965822598219896,24,7,30,50,144,20
0.9764011915285976,3.1191444449056274,1.6847462225192493,0.6517938094933445,24,7,37,55,145,18
1.1416867973854918,3.2807668227993956,1.898072525120351,0.7375100280271412,28,8,34,51,145,17
0.9620537670360545,2.9713108220297073,1.6415491740477237,0.569294262604267,24,6,34,57,146,23
0.8990644263241361,3.0622583504624705,1.6665453786203432,0.5318922610239254,23,7,31,54,143,23
1.2807320728852745,3.336821845736748,1.9980711576845516,0.8698686266546568,28,7,36,56,147,20
1.1613760421392665,3.2026909499622422,1.969995992653815,0.8381799927900617,26,7,32,58,150,26
1.0037190563044276,3.1136898158534785,1.6820349416181544,0.6934182041640857,28,7,37,56,146,19
1.1400204792804964,3.369295134575971,1.8944260429665414,0.8454055095919659,26,8,33,55,145,22
1.1333130114533234,3.1400402301381822,1.9577460913925293,0.7927047656920017,24,7,39,57,143,18
1.2338906206951221,3.3685429486992717,1.9701743006940884,0.8413028563059577,26,7,33,57,142,24
1.1203995368317567,3.1669978427124477,1.825261628599915,0.6981715190243856,24,7,35,56,145,21
1.0492056378909018,3.074386457045212,1.7714589612873306,0.7490577328384891,21,6,39,59,150,20
1.029943337658537,3.1583915444395565,1.7854982422485812,0.7571494489052869,26,7,34,54,143,20
1.1596274049074144,3.3617332912200144,1.9348604327019454,0.8264901307578058,23,7,39,58,149,19
1.2031661159215816,3.1244363746111494,1.9665333033956016,0.8462606644214288,22,7,34,58,143,24
1.321665993854511,3.365437751758364,2.0272039547713394,0.8738829010871011,26,7,33,51,143,18
1.0487194840870724,3.183392495956946,1.802937095360957,0.7183197295860949,26,7,31,53,146,22
0.9905224291092805,3.083691579161255,1.7418855189530233,0.629877075098231,27,8,33,52,145,19
1.079312121310715,3.287625769068449,1.8807604456943954,0.7742679319233434,27,8,34,55,143,21
1.1961601515842486,3.323654932226775,1.94322165384052,0.7943794547504381,26,7,39,57,141,18
1.1498085254492523,3.1697232472327825,1.9336376315191766,0.7307688035880818,27,7,35,55,139,20
1.1722497345878105,2.9755524267075,1.8806574111873877,0.8181509038422675,24,6,34,51,134,17
1.1230564330886608,2.962631117093708,1.7674583755379465,0.7253045557896756,23,8,32,54,139,22
0.909238720290328,3.1066335755876384,1.626151293408356,0.5821475600484758,27,8,30,53,139,23
1.1602352563001006,3.3449833604832766,1.947384815898418,0.8109962460268915,25,8,37,58,139,21
1.2343626101007066,3.2992494993518426,1.925954924109719,0.778053161902313,22,7,35,56,138,21
1.0897944669382378,3.1381285995457153,1.832438761733825,0.751108353897913,24,7,32,51,134,19
1.0061860174201562,2.8648382401769465,1.7080119000274665,0.6596710381987166,24,7,35,55,139,20
1.1413774231294593,3.2910324290810102,1.8303057704286179,0.8017673931235542,23,8,32,53,141,21
1.2453658977145183,3.059987390262465,1.931715793548936,0.8786395898870869,26,7,38,59,138,21
1.01039109773019,2.5895726262463823,1.4535572728549706,0.5855638306305774,26,7,18,55,139,37
0.8932063871753347,2.5369159201983527,1.578913895290802,0.5354272975590844,20,7,33,54,141,21
0.8643940986039147,2.7868535882177747,1.5348400513361482,0.5367245357462178,25,8,33,53,136,20
1.0946169142773006,3.2021350679428258,1.8630526478901341,0.8486253494532999,24,8,36,55,139,19
1.1770921337932942,3.190136992719439,1.8824997391867382,0.8450487894908665,25,8,38,58,134,20
1.318737156234046,2.8869567589313863,2.0207958133992987,0.8838081104284952,24,7,34,53,131,19
1.2703054187867677,3.0972471247265805,1.9697642873051242,0.875993220636133,24,7,36,52,127,16
1.0451580982411426,2.816738270158473,1.612831273209692,0.6676559536545481,25,8,36,54,127,18
0.99250272558902,2.9195077411144155,1.612534320388317,0.6224352837495098,23,7,32,53,121,21
1.0890940425935183,2.6157431003939218,1.7359558757361646,0.6799304251537388,21,6,31,53,126,22
1.0762586463670452,2.9467948030320055,1.73964991351936,0.7146183677292902,27,8,30,52,122,22
1.1858059536884586,2.909900932241457,1.8246033012248755,0.8050691031026984,21,7,36,59,128,23
1.2039725083509911,2.994057582523468,1.826063848810334,0.7427156407069244,20,6,28,51,126,23
1.1362294198674268,3.0115861568245945,1.8000267864788706,0.7901595481651409,17,7,31,54,126,23
1.3984733920091832,3.2912023012134384,2.034534906091692,0.9677217423960742,26,8,35,55,125,20
1.2474752522732477,2.9465802559612633,1.9934474751464692,0.8402697121005438,24,7,31,52,125,21
1.0422971767399085,3.06634844380056,1.640139660079004,0.7323533889362899,22,6,35,55,132,20
1.1497257822843014,2.9108340619236035,1.8147192450349219,0.7760959738805004,21,7,35,58,134,23
1.168257899553637,3.2230943460005914,1.8756513744058059,0.8545622171678284,25,8,34,56,132,22
1.194172015861779,2.959299170534476,1.8442760706566257,0.7701442989712328,23,7,36,57,132,21
1.2826445456402409,2.936274069886961,1.9516455966745352,0.9369739792034723,17,7,31,54,135,23
1.0229757667174941,2.7892670567728235,1.7053613731253494,0.7591290511473318,18,7,38,56,145,18
1.0485075154618277,3.041897230179912,1.7051792695910954,0.6856243989799635,23,8,35,55,147,20
1.1643645713261386,3.191223797233325,1.8638651964389705,0.8431899397203619,20,8,37,55,138,18
1.2707762435036092,3.0287847446111273,1.9466555467894189,0.8296376772409046,24,7,36,55,139,19
1.107816771452494,3.062084740547365,1.7865413548779365,0.7690196234339615,24,8,37,54,144,17
0.9706414053579093,2.924893922297872,1.5750091114914384,0.643650307462357,25,8,34,56,140,22
1.0562984652809542,3.024473305935363,1.7445329081739596,0.7018241208198258,23,7,31,54,135,23
1.2634480977514242,3.133869032267091,1.88851750450044,0.849793324034994,26,8,36,56,136,20
1.185583297381359,3.043960370350535,1.8579645371726263,0.8145011182157822,21,8,31,57,137,26
0.9088849995825543,2.6516325999879706,1.5008615301367991,0.5579736006792302,25,7,31,51,131,20
0.9884324676714479,3.0075889064511427,1.6379998547115198,0.708483054883449,25,7,34,54,133,20
1.1206514572581672,3.1172884621407593,1.7595888985460366,0.8040972153002031,22,8,37,57,134,20
1.145375601707086,2.7576234580890757,1.7231985953098223,0.7003339834272871,24,7,30,52,131,22
1.2462472320334852,3.1277526269538347,1.881049939046271,0.9199174590891961,27,8,31,54,131,23
1.0281023015365258,2.7486088769379484,1.6285634376373403,0.7522852156209252,22,7,36,56,139,20
1.0999535156215887,3.062784797269366,1.766273154508891,0.8007942964397243,22,7,34,56,139,22
1.023395618862656,2.9716682978527813,1.6712292601137027,0.6653459912757346,21,7,35,59,132,24
1.2875527713736323,3.0559522832365578,1.955697477377407,0.8991084258016744,17,6,34,56,137,22
1.0678518901382543,2.9991860688963863,1.6221099828209296,0.7540434034603818,24,7,33,54,135,21
1.0727452817537007,3.073288957867341,1.6851134370329046,0.8119651365017275,18,8,31,52,127,21
1.1025598230781815,2.425947564621674,1.7995561495592036,0.8068618365068341,22,7,36,58,129,22
1.1889451801182322,3.0363957178467214,1.799717887514605,0.7752146514601541,24,7,33,54,129,21
0.9893530266011367,2.6822126237387556,1.6314053288347816,0.6801792716976409,24,7,30,51,127,21
1.150186588354909,3.0987759454376915,1.7993177703508494,0.8177381124096017,29,7,32,54,127,22
1.004839330104072,2.8970874789094943,1.6554899794453743,0.7375778723712968,21,6,33,53,132,20
1.0295440678880667,3.0257902721050294,1.6880981011670448,0.7291021924867057,18,7,34,54,135,20
1.2604310547648534,2.9034480682265347,1.8352287196611896,0.9850174197144906,25,7,32,55,132,23
1.2112894236946734,3.038634889534274,1.7792514543991689,0.8531774805832941,25,8,31,56,132,25
0.9658867439290728,2.6695604788364555,1.586600874198775,0.7024142766486301,19,7,38,59,134,21
0.9725753133803418,2.838580863647091,1.609533342877707,0.803288213429131,20,7,36,56,136,20
1.1341894572349858,2.8877985263291763,1.72799197337664,0.8419718770864675,19,7,34,53,131,19
1.2766132871589906,3.2231849807269786,1.9133302647207462,0.9139772837174294,26,7,35,57,130,22
1.063702079358738,2.8846672106670543,1.6036266994944954,0.6718411045840187,25,7,37,59,130,22
1.0438757018630314,2.8733940880091478,1.5938546550143518,0.7061341522778255,27,7,27,52,127,25
1.1222747523128367,3.0180206787325403,1.7719134705624617,0.8369254054693265,22,7,34,55,131,21
1.2143371518509884,3.171408508141152,1.8312468287790522,0.8912188161101364,23,8,33,56,127,23
1.2519705928788896,3.073839189615709,1.8665716053180277,0.8181484919358062,25,7,33,54,125,21
1.0495422484307526,2.8878880032574865,1.6414068074090409,0.7362861459063906,23,7,30,51,126,21
0.9354943844984832,2.969318124042312,1.3788262493166428,0.7198366982553802,20,7,17,53,124,36
1.1127764077897238,2.973384702474741,1.7305333382059287,0.7520840910922868,21,7,37,58,121,21
1.1491379636317947,2.941705789516377,1.6356591880680362,0.7675099922642628,25,6,35,52,122,17
1.0726939949634304,3.0454290423975268,1.709660791277987,0.7489127132082933,22,7,32,53,125,21
1.086210388201809,2.8620642152493114,1.7919632934652927,0.7817931501834497,23,7,36,58,123,22
1.2487039345115079,3.019772937607729,1.892194761951945,0.8471132853913494,23,7,33,59,124,26
1.2167820696820821,2.9594868962838166,1.7704660661147222,0.8057120825556078,19,7,29,52,129,23
1.0567592839491493,2.7145043801122406,1.6413093774251957,0.7480436070955758,27,8,27,51,128,24
1.0871012440112913,3.0064524951039844,1.7349583523378127,0.8451813760182588,23,8,34,56,136,22
1.0620335651814203,3.0555781938388176,1.7421878523316776,0.808535866003184,21,7,36,59,134,23
1.1271243220965976,2.743952344983131,1.7042354625589875,0.7695851209720022,19,7,32,56,135,24
1.117247844174576,2.90672631278097,1.7128789287249542,0.8171825202177458,27,7,29,51,130,22
1.0920064812296304,2.9861433191523594,1.723345923353952,0.8070908746569742,23,8,36,58,136,22
0.8760779033417717,2.7996873624675898,1.510066431723122,0.5384388239303195,25,7,32,57,139,25
1.1510649063852965,3.199914829977824,1.8577312177726861,0.9143285317628898,23,7,32,54,137,22
1.1546816859465954,3.1228067359475293,1.8301923693894393,0.8768927377046842,21,7,33,56,134,23
1.1443611528562725,3.0918449822415104,1.8087534199051685,0.8859996476797605,24,7,36,57,138,21
0.6747070148685418,2.5858444660788127,1.3590058322261147,0.41125931153110107,23,6,33,54,143,21
1.0344007875543082,2.8904928247954618,1.7143636901190897,0.8418598001671328,25,7,34,52,145,18
0.7763632100761381,2.721997123942807,1.4966991833845527,0.5332048021520343,26,7,34,52,138,18
1.2760840980496406,2.771265776076617,1.9388925539127204,0.9390724494878874,23,7,31,53,142,22
1.0984668383847258,3.0769308310548524,1.6952491835935395,0.8508785034067375,28,8,33,55,138,22
0.8812905582735967,2.738396265160182,1.5254089590633435,0.5879626271420577,25,7,37,58,143,21
0.9522172827784515,2.9526295251934465,1.5460528880461566,0.5577351544048403,25,7,32,52,135,20
1.112122554441026,2.9031320808256904,1.7600921585921545,0.7892376572077965,18,6,35,56,135,21
1.0201891085146908,2.8415292961301004,1.7623451288203862,0.6997531927728979,26,7,31,55,132,24
0.9981566801782226,2.8640262613039438,1.6166907530270982,0.7960135793088233,24,8,37,57,137,20
0.9898993291969087,2.865088043881204,1.6067604774780144,0.7103690978156321,23,7,27,52,138,25
1.0075665643612401,2.76248781946748,1.691137337531877,0.7627509761883192,21,7,29,53,139,24
1.20588199387107,2.86671084862504,1.7711505611559764,0.81905447218032,17,8,33,52,136,19
1.1377268624673509,3.072908337040505,1.8251512278312298,0.8889337189001941,19,8,30,53,140,23
0.8481926117035272,2.6141403149895153,1.561081296896071,0.5945521525523259,24,6,36,58,144,22
1.0130944245299673,3.1185821862748115,1.7884181170342213,0.8452521836538329,26,8,30,52,139,22
1.0337729226512204,2.9431640307294793,1.758877384663447,0.7830141694437969,22,7,33,51,139,18
1.1985103089531335,2.7756687411001546,1.8138968397355884,0.8313183019284072,26,7,35,58,142,23
1.029014873863422,2.9683849753754683,1.631303846478111,0.7671343996472425,27,8,35,55,138,20
0.9277383175085102,2.731537287286716,1.6379708382534808,0.6445698733270152,19,7,34,56,143,22
0.981000377791796,2.743666849872957,1.616390464131399,0.6402119251267455,25,7,29,51,139,22
1.2432818194717,3.0317505342804547,1.8748149486853583,0.9229180668328707,19,7,35,57,141,22
1.2610816320694045,3.0795270299465267,1.9723180227435733,0.9462267305644363,25,8,32,56,135,24
1.125311818809879,3.101709787391788,1.7661582034355878,0.8334356873891884,24,8,35,54,133,19
1.0665391986110844,2.8014758976760787,1.6789221593758343,0.6781461939918061,23,8,33,57,138,24
0.9012865053336867,2.9320786701053354,1.5515422220177673,0.6236225925992323,24,7,33,54,142,21
0.967962419967872,2.981498599794253,1.6495406978366325,0.6572713105751331,25,7,32,54,138,22
1.2065419608526238,3.129965970644248,1.9261515796088733,0.9165108310716796,27,7,34,57,142,23
1.0560470325995364,3.095875593021165,1.7293155885383256,0.7880522129739552,22,8,34,60,146,26
1.0514714990390281,2.968363773152406,1.7017023085609395,0.7868982467536989,23,7,31,58,146,27
0.8796328426403788,2.912545067038491,1.0639621220434246,0.771449927530572,26,7,16,52,137,36
1.1881996612682821,3.086457133293795,1.842699543981293,0.8462881939927891,23,7,27,51,134,24
0.9805347072675855,3.0172186321052155,1.7050398723876135,0.7300141123599695,21,7,36,58,140,22
1.0899195715038288,3.0300122579117215,1.7237368668909085,0.900314999313494,20,8,36,57,144,21
0.92683302342165,2.774927385170856,1.6564770791153625,0.7284544732721381,25,7,34,56,143,22
1.1464711912727643,2.9467920693528464,1.8212815475018518,0.8651230048537438,26,7,31,55,137,24
1.087186172625489,2.9886662727966558,1.7452357590499472,0.7496584103232151,20,7,28,49,135,21
0.5688593311605598,2.7616394726004496,1.9331049869924457,0.8322075437124241,15,7,34,58,143,24
1.056395329759556,3.1455493028255086,1.6908638467449997,0.7878615076668638,25,8,38,57,144,19
1.0353454961344568,3.072311337367614,1.8098502072403866,0.8723500883597299,21,7,37,60,148,23
1.032836392433814,2.8987272638582153,1.7344546570997643,0.7175635765842935,22,7,33,52,140,19
1.073414148918089,3.104953399106486,1.7934769588147552,0.7624743708919913,24,7,34,53,137,19
1.0734817259277611,3.096630788151747,1.7917750740960476,0.8041778252865185,28,7,33,55,141,22
0.9702706550316297,3.038468016942824,1.6673722937997764,0.7925130650015486,25,8,37,60,144,23
0.9660704887999599,2.86047003029583,1.6989507333888203,0.7591764823005214,25,7,30,56,146,26
0.9622151889025261,3.0296787318492124,1.6823101340265976,0.6961338208002152,27,7,35,57,145,22
1.2864270763163903,3.200392554038563,1.9404950554938463,0.9550711512109122,27,7,33,55,145,22
0.9550134998306598,3.037147850006377,1.6632731424491487,0.7792706164003145,26,7,37,57,147,20
0.9291854811236361,3.003123897472748,1.637220643476741,0.7063354266688571,29,8,37,57,145,20
0.9734341313807329,2.763102515990863,1.6629616326680683,0.674714581770302,19,6,35,56,147,21
1.171259363190193,3.003166706096893,1.8174172128149277,0.838873303382923,25,7,33,54,145,21
1.2172592331105496,3.166826254984474,1.85517494229788,0.857156322914413,21,7,35,57,154,22
0.937544341653601,3.0326988019404406,1.5036322183812068,0.5963407407538406,27,7,30,54,152,24
1.1003358434580808,3.0526587841506707,1.7420341644152793,0.7609554776473881,24,7,36,53,144,17
1.1106056982264048,3.1657421093088023,1.8763525757119228,0.8853384421109289,28,7,36,57,141,21
1.3236915452006888,2.9107269552864343,2.0570049930850085,0.9497585553878841,19,7,31,56,142,25
1.1438454429632317,3.151054170145712,1.7101769458044687,0.6952613870483777,26,7,24,53,139,29
1.0426812613035823,3.046756912478659,1.2231872350704995,0.7177126917619087,22,8,11,47,133,36
0.6199206785561946,2.3398694144997227,0.8747342887275419,0.36592641185831265,19,8,13,50,127,37
0.505712090897601,1.7865271528196,0.8151710967148051,0.22763783971085572,21,8,22,59,139,37
0.6894771788765732,2.162439783475186,1.4755049629793051,0.4593568529822901,26,8,31,51,138,20
0.861965676577427,2.5113297130055496,1.4915303641970679,0.6710711378418828,23,8,29,53,143,24
0.8482471708526594,2.820419567714313,1.5144004032649305,0.5477006642082056,26,8,31,52,137,21
0.9936799809186347,3.017257475429661,1.6394949635001186,0.7686842589336231,29,8,32,54,143,22
0.9999816181210663,2.767720801684865,1.6277235282266915,0.71955924409468,27,7,36,58,139,22
0.8973285808988873,2.7686967976793153,1.5475169734988743,0.5779429138481793,16,7,33,55,138,22
1.1340088037828706,3.0445528653483445,1.7600599367594894,0.7463694951067865,24,7,33,53,134,20
0.9402149983645003,2.912235331760367,1.5652562694492904,0.6165735795129744,26,7,32,52,127,20
1.1271394303398272,2.704577154836942,1.8487445097603135,0.6627524399319337,21,7,35,53,134,18
1.053622500130187,2.9777254052843904,1.655903904247825,0.7428723838754291,17,8,28,54,134,26
0.8861318265004853,2.833483078406539,1.5275095246339774,0.6384439933437128,24,8,32,48,138,16
0.9303909076568561,2.7142308153295023,1.5269580928460247,0.6754607270456013,17,7,32,53,134,21
1.0977181927104611,2.8874373088302527,1.7380365605301547,0.7341686605512058,21,8,34,55,132,21
0.7858357455038455,2.715296056937478,1.5074168408847761,0.6146484081612091,22,7,33,59,138,26
0.7863160304720466,2.735392597816147,1.433539666835559,0.5071216481228735,25,7,34,53,142,19
0.795266413967263,2.7059488773621028,1.4841243574308933,0.5411458490168811,23,7,33,53,142,20
1.0228544075510217,3.0136605801817082,1.6609612920721548,0.7783211523958933,22,8,33,53,139,20
1.040129213241923,2.9820976593616217,1.6829488144874474,0.739002732438627,22,8,36,55,139,19
0.7362800230937954,2.4741597451295276,1.429257138190728,0.47050920879934943,21,7,31,56,139,25
0.987713220990525,2.63658347294385,1.560901973783785,0.7089187346465179,22,6,33,50,137,17
0.8344177563686421,2.790338926702429,1.4824095799671393,0.6056752401388614,17,7,31,50,139,19
0.8729323976368619,2.771404035915406,1.57149954980486,0.6498011494225875,26,7,34,55,136,21
1.07526476585749,3.0824813796315356,1.7263129887975468,0.7846461301283161,26,8,38,57,134,19
1.0986969367042807,2.8890479519621373,1.7292102600298367,0.7596025106370659,26,7,34,56,140,22
0.9551304725820429,2.9607516723172442,1.5511439365373176,0.7960245268466609,25,8,36,57,138,21
0.9838478353583856,3.056422346066728,1.6041134213511095,0.7837306478853562,16,8,33,55,131,22
0.9113744155954998,2.882932553847839,1.576087697399639,0.6363025158744648,19,7,34,55,132,21
0.947934056068469,2.735032793017215,1.613198953779931,0.5406754255366251,18,7,32,54,126,22
1.0323279002154309,2.6664426064761657,1.7458750397287013,0.6308402593340237,23,6,33,52,131,19
0.8344688103884896,2.6474308240410593,1.4165672616475598,0.45977369353938036,17,6,34,53,135,19
0.940033567640975,2.86729857584638,1.5705646539021325,0.6384957505972338,25,8,38,57,142,19
0.7648204031463317,2.6878393979733888,1.3793879832532292,0.42849568110275993,26,8,34,58,137,24
1.000480791542919,2.748009954549472,1.7022518130702236,0.7087349105415024,24,7,36,56,139,20
0.9912078206842319,2.6993263999356154,1.6021586032676074,0.6911091723367264,27,7,32,50,136,18
0.9145065501188944,2.756810308143929,1.4837791810478844,0.5806055338495165,18,8,34,51,133,17
0.8790803813199659,2.814999395325696,1.5500271725173027,0.6542271448034916,26,8,35,54,140,19
0.9779930489170472,2.6909179090443986,1.5662286882661862,0.676146066395766,27,7,37,56,138,19
0.9412503293070051,2.612346466833224,1.5771965514573099,0.5842611189766087,17,7,33,50,131,17
0.9991010043944984,2.589278002644331,1.5947372023070383,0.6630859888398264,26,6,39,59,135,20
1.0170860092597578,2.914596146537368,1.5528367005859758,0.6743546491967036,24,8,35,57,133,22
0.6053574221549074,2.486959709702718,1.20338271776847,0.29087178081137144,24,7,34,57,137,23
0.7815561822846714,2.6476227574435276,1.3728055910826509,0.4325433323817317,26,7,33,51,137,18
0.9546095316346853,2.841623481726251,1.5894733482048715,0.6782546856647949,27,7,34,56,136,22
1.1005241117268942,2.8981178181242893,1.4299284096417917,0.9641895014192274,27,7,20,54,137,34
0.9248677068681254,2.8529745899897145,1.583260737027882,0.6348855316597779,23,8,35,54,133,19
0.9314934358924937,2.683139645768766,1.5188293769415881,0.6047314526009744,23,7,33,58,140,25
0.8422202291313794,2.4396880711648485,1.4570503090178715,0.5720765888370105,25,7,33,57,144,24
0.9976626952280019,2.708472819412714,1.5799393617725814,0.6491569469187319,22,7,35,54,142,19
1.141410324810395,2.9958201956520916,1.731034128118614,0.7501712682692883,29,8,35,53,137,18
0.8993806653158798,2.7426513723923396,1.4739673869485532,0.5388657623378311,23,7,40,57,135,17
0.9831242942735897,2.828581558615652,1.663837344368463,0.6178954613408913,22,7,29,49,123,20
0.9822391318006641,2.7057682200649795,1.6362102408280235,0.602044268242821,19,7,36,56,130,20
1.1706508575888805,3.0853531984038503,1.8061997237594363,0.8073926770514545,22,8,37,56,125,19
1.116139918985968,3.1318482254648274,1.7773998778212312,0.781174064583139,24,7,34,57,126,23
0.9751337677574907,2.806204116412597,1.6228804184744465,0.6579284663103235,19,7,32,51,123,19
1.1912805140487843,2.944670353130306,1.8171944224884726,0.853093460896208,23,7,32,56,132,24
1.116679562999207,3.1042884466037037,1.7665396402517386,0.8574414059667741,17,8,35,57,132,22
1.0084969210579633,2.747102514026125,1.6065278586713014,0.7098545212151257,24,7,33,56,136,23
0.8230477042881625,2.666014773602102,1.450234511764205,0.5431652837881549,21,8,28,49,143,21
1.0594400217608775,2.7894198734041553,1.66454477608998,0.7636239902740198,23,6,34,50,139,16
1.0211931203078501,2.6807339352976554,1.6670430958147857,0.6920461349334002,25,7,33,54,150,21
0.9199306551515465,2.9274965163133704,1.6826475969235832,0.7641388447001083,28,7,36,57,155,21
0.9856143672145095,2.803535574364382,1.491060057922204,0.8580673991018645,17,8,31,56,157,25
0.9082457402767627,2.9755301041307267,1.6441886942556518,0.6982078082891765,26,8,30,55,149,25
1.189787037008073,2.7246112916368324,1.7017969582874573,0.720505398928351,25,7,33,55,147,22
1.073810251341658,2.6968276894248726,1.7877320486847137,0.7578196202387028,25,8,30,51,146,21
0.9866754095242264,2.919175182799696,1.6576186414482856,0.7312843854552906,21,7,33,54,151,21
0.9434133450513862,2.83196868475647,1.5371694216941174,0.6529286249908044,27,8,37,55,154,18
0.8776014220773971,2.8297747295074234,1.6067732964657093,0.7231352777737231,20,7,37,54,146,17
0.7569329606471953,2.7940109433923235,1.3945302053618882,0.45178693295519756,24,7,36,56,142,20
1.1191007354601603,2.90291479674626,1.7598255683802249,0.7795240378400152,24,7,34,52,142,18
0.9674508349494337,2.9181711681958706,1.501976074725338,0.6461758533660554,22,7,33,55,146,22
0.9061352041035006,2.6589015456692335,1.530879764191528,0.597817563201873,22,7,29,50,141,21
0.9634167596073542,2.907918176450618,1.6535217602295154,0.7088009428578845,21,8,35,53,143,18
1.0142046894303622,2.77746838718559,1.7340510139806524,0.7217304909190773,25,7,36,58,140,22
1.0590169687093187,2.8865375585717628,1.7082888834875016,0.7312168478526131,25,7,31,52,135,21
1.0490579342455262,2.479028325416827,1.6666249222370022,0.7983136450515254,24,6,28,56,144,28
0.9877616262180942,2.991633876547078,1.6022379972506702,0.730329051463654,22,7,34,53,142,19
0.934531734346798,2.9074978591571385,1.5905441149515538,0.19018083457255786,27,8,32,54,144,22
0.8494389439862946,3.0757921950817853,1.7335653398986715,0.7157785339221611,56,7,40,56,148,16
0.9916176554916896,2.901729271469195,1.6664239113071504,0.6742461433773637,25,7,33,55,144,22
1.0675614174074257,2.8505286626235744,1.7425639109755438,0.7135119626483153,24,8,32,50,142,18
0.6206326951908656,2.531627970676909,1.4215416145256095,0.4949376170073858,22,7,33,51,150,18
0.8226908880282027,2.7634492007846827,1.5500828537271154,0.5839065645372137,27,8,34,55,149,21
1.0949852260166042,3.1174955538825366,1.8089984865827813,0.8354260969156279,25,8,34,52,135,18
1.0358505822278854,2.7387297649269264,1.7515843343904645,0.7084549745269159,24,7,38,59,142,21
0.8777013048547054,2.835072226316742,1.5752073726892482,0.6166365865332832,22,7,29,51,133,22
0.9236342213551733,2.8794551257616208,1.621972878767512,0.6544963703760662,23,6,34,57,140,23
1.0200916251525272,2.8242055499920733,1.7243640614805913,0.7664637240371353,25,8,34,57,131,23
1.2560448961907726,3.1109679627282745,1.894882783408075,0.8213411902182706,22,7,32,55,128,23
0.8234262671841357,2.5523817757742275,1.5262969334681316,0.4997109805395652,19,6,34,56,130,22
0.7760352989639181,2.715295916237541,1.4912628843812317,0.513774588968477,25,7,28,50,133,22
1.0640861830530222,2.92012199811688,1.3903247396309093,0.812136763067922,17,7,23,30,142,7
1.0105886904877144,3.013777473525854,1.6642340065432593,0.743086672001612,27,8,37,54,142,17
1.2103281811766557,3.060920982898674,1.898315621824596,0.8804883830369059,23,7,38,59,138,21
1.1458411488657383,2.9213445517764676,1.763474130543466,0.7374924230861958,25,7,32,55,146,23
0.857182613342153,2.8257623964326717,1.5951100344175702,0.6241737163099093,26,8,31,53,144,22
0.8557604894116355,2.801439906692488,1.5725705663468053,0.6457425661952038,25,7,37,57,160,20
0.7660212208966464,2.8305232581961466,1.462524670649327,0.5370126015031846,26,7,32,51,153,19
0.9927531297660712,2.9957677333071753,1.7105871621679554,0.7015204189869559,22,8,37,57,149,20
1.1799464945235207,3.11455870525898,1.7576285991003668,0.7495569915721159,26,8,35,57,154,22
1.0719361355465087,3.0098020169905206,1.8035283608629284,0.5152533597687143,27,7,36,61,154,25
1.015274407006104,2.9571036983414754,1.679715273901177,0.7577501391126846,26,8,35,56,158,21
0.8816669568812707,2.7989516962500405,1.5917947346951968,0.6317905032944089,25,7,34,52,151,18
0.8706017613547592,2.6746498333422846,1.516414966277167,0.5325429046674968,24,6,32,56,151,24
1.1719473733700856,2.7717517994726526,1.8299822366588328,0.8229037797281373,23,7,37,59,156,22
0.9797992275640783,2.7656255667977554,1.6114551604650384,0.6800447168433834,23,6,37,55,158,18
1.3161679951457605,2.6989909286804576,2.141339107457667,1.032469442837475,28,8,29,53,153,24
0.9465666102511441,2.902262413254769,1.7162710120778981,0.7007915479097476,25,8,36,54,154,18
0.8674660166681704,2.867191891092679,1.5601466559486077,0.6156558466804923,25,6,36,57,157,21
1.1296499880633843,3.1467315928239943,1.8539762679542364,0.8252171696152859,22,7,33,55,152,22
0.91736781417603,2.7474817965698217,1.331052785197427,0.5492603798721667,24,7,13,51,153,38
0.9589292504858455,2.9513003025965725,1.574792190981048,0.651796779061815,25,7,32,53,154,21
0.9024238840123164,2.819879250660147,1.5930638833682824,0.4351083246207814,26,7,33,52,153,19
0.9867658813531829,2.847848737962493,1.692703266748821,0.6910394739514341,26,7,36,54,143,18
1.1341286831498814,3.1436738403789226,1.8056084683293223,0.7621102738187066,19,7,33,54,142,21
1.1468878682910968,2.9508540751284125,1.8539929721599095,0.8648942048965288,26,6,36,55,147,19
1.0050676704607233,2.7406074174297075,1.7012554563587625,0.7068000385676374,21,6,32,56,146,24
0.8856870169279332,2.8508479238728253,1.526107570974487,0.6120119673266471,22,7,32,52,145,20
0.9122756633536495,2.7173074690407764,1.6555259821523176,0.6506584665753663,25,7,34,54,154,20
0.9487325500069832,2.9730794096397863,1.6825104171281497,0.6847274258704117,26,7,33,56,147,23
1.1465080510404984,3.039513115020612,1.9226934019643305,0.820129058882692,25,8,37,56,152,19
0.9703344684468577,2.9231354926180484,1.6861426375798088,0.7580840259470776,23,8,37,58,154,21
0.8770175108055331,2.938847265538036,1.566335808583776,0.5710977774355122,28,8,32,55,149,23
0.975460544729296,3.0892668371993235,1.788303796115449,0.6718767260073648,27,7,34,56,147,22
1.168630033469461,2.9269491742951566,1.875636419431587,0.7698334029599854,21,7,39,58,149,19
0.9921638262588011,3.0118168655569173,1.6823974626682752,0.6743105760475749,26,7,33,55,149,22
0.8343725283655872,2.8127345178168848,1.594820412840291,0.5781843165320981,27,7,34,53,146,19
0.9218637012689759,2.958005875085805,1.654163338500569,0.6347122687661824,28,8,34,56,147,22
1.0647380014393333,2.9656894796210214,1.7794969795154842,0.6726960002625042,21,7,35,58,146,23
0.9524016591258597,2.928276843508985,1.7834140632289015,0.6623597092135689,25,7,36,53,144,17
0.8658544696352428,2.861547126824177,1.5386422496281689,0.6169342319663069,24,7,32,55,146,23
0.82455434298862,2.739726241052992,1.5331891161869589,0.5282220440599854,26,7,36,57,149,21
1.1374196633047686,3.2190092891457014,1.894447030542527,0.6466431569577719,27,6,34,64,138,30
1.2692815838920457,3.1113159791542633,1.9220688841488327,0.792661679872354,24,8,36,57,135,21
1.1431519414372917,3.0124159573362252,1.8090723564161881,0.8448451678569022,26,7,31,53,133,22
1.10670455452288,3.017818310424243,1.6884254559163525,0.755503568737057,18,7,31,51,133,20
1.0288639452157886,2.935056788046232,1.6094581812735975,0.6878690076152897,22,7,34,53,133,19
0.9473004037146406,2.9260602772279483,1.604348497624895,0.6022652080571113,24,8,37,59,134,22
1.158373618659645,3.127746180208124,1.8258348180080441,0.7390740380515389,20,7,30,58,136,28
0.8668076202493666,2.7521032302682107,1.605522100615562,0.5459748870246901,25,7,33,49,134,16
0.8680102748053706,2.847357846731194,1.5475451267167888,0.5790802310178679,26,8,27,49,137,22
1.0121992567629865,2.7711330655134296,1.6580116137906369,0.6560809542361348,20,7,33,56,140,23
0.9596884908524528,2.472785726902353,1.6687071628487664,0.7330386387352869,18,7,38,57,152,19
1.061106793134599,2.650665192457171,1.7564929112605712,0.717271991697495,25,7,33,58,146,25
1.054112148732985,2.856837606311518,1.7321784670745441,0.5466042894063133,21,7,33,55,155,22
0.8749379999702394,2.6445039272239343,1.559479568614461,0.5738162688388068,25,8,32,54,153,22
0.9258060957299709,2.8588995779174455,1.499487734594622,0.5944918961936829,27,8,33,54,156,21
0.8343170701382102,2.7847330791101585,1.5521243721677127,0.5802709669342649,26,8,37,53,152,16
1.1881227313378435,3.1294124019504763,1.8532884705734696,0.8389906961069864,29,7,35,53,151,18
1.2127102735317603,2.863246843952869,1.9115124176406595,0.8271539585184933,25,7,36,57,155,21
1.0116912637351094,2.844141083251512,1.773850791148162,0.740139501423717,21,7,34,58,153,24
0.9735473396545342,2.8813964997949117,1.663694746092219,0.6513694355014936,27,7,36,53,153,17
0.8382345747371492,2.7125755609237743,1.5742077227882343,0.5291871249578659,25,7,31,52,144,21
1.2045233819558818,3.06253509176625,1.9147026141156074,0.8157421385560247,25,7,32,54,146,22
0.9368951873373909,2.9061809422696445,1.6132323580190864,0.6426276215180627,24,8,37,57,144,20
0.9353409039098401,2.8738428784520553,1.6338780677684592,0.5837706190486409,25,8,38,56,147,18
0.9773981793395384,2.9974009648612405,1.6487835816232637,0.6471201582376124,27,8,25,54,145,29
1.1577117897722597,2.951238663106995,1.8521866138354688,0.8025085703763923,26,6,32,51,141,19
0.9398895594323824,2.922916693596873,1.574342302996326,0.20465298039577573,22,7,34,59,148,25
1.0381997018520317,2.8458993520386233,1.7529998375542726,0.7503359202781769,16,7,32,53,148,21
0.9714698950221736,3.040071980588649,1.6505975259862087,0.6761767479406664,22,8,35,52,147,17
1.1224727853600271,3.164039746292758,1.829092549069455,0.37945497439670917,27,8,35,63,152,28
0.8070777032484645,2.76255791051049,1.6496675131661627,0.5511110188804735,26,7,31,57,151,26
0.8946677674862897,2.6692114378456644,1.640248076585474,0.7328489383668076,24,7,35,57,156,22
0.7886789583076788,2.6966403226842806,1.4698196670375299,0.5150211447462878,16,7,34,51,158,17
0.9914637967667004,2.9398087851047174,1.7235585562665863,0.7010585677848076,25,7,35,56,156,21
1.128336014535965,2.826330510209589,1.8206351669963965,0.7757037472149678,26,7,35,55,150,20
0.8663322603629862,2.804798299747649,1.6130841087124792,0.5028959144147476,28,7,33,54,146,21
1.041154320445892,3.0008638248196995,1.4822605384056002,0.7602017533814169,23,8,26,53,151,27
0.8741985830637862,2.7945802150524117,1.6884695682415303,0.5956477066252033,26,7,36,61,159,25
0.984213031995566,3.0128211273013696,1.7797088268383692,0.6446484874946463,25,8,35,60,151,25
1.0468873535336138,2.819757665280773,1.363582141463167,0.21081889623253947,28,7,12,50,147,38
0.892065295765228,2.8867215381548936,1.690970924111197,0.7262272711551203,25,7,31,52,147,21
0.8730749328749268,2.641606417009516,1.568387503239911,0.45156008510705237,24,7,31,52,140,21
