0.9374735081003488,1.4179884040104782,2.309547844377202,0.3061650315233857,23,11,6,44,91,38
3.129709550362714,7.944680968693023,7.920781596599747,7.189065128883362,47,22,54,64,116,10
-0.31738445922262937,0.5907547534082425,2.319859039267661,1.384533733612532,19,5,17,41,150,24
-1.0053814235231646,1.7031510517864226,2.247427536657928,0.7738791698318119,49,15,7,43,133,36
0.4190998073292501,1.1779535653472424,1.650055871198617,0.23641276806896772,46,13,7,44,134,37
0.7186808907182181,1.2541871295519464,1.989756224308948,0.5055489152984844,24,15,7,47,157,40
0.876922602800646,1.3593039219531944,2.0817589656739868,0.5616128584005796,23,10,7,45,186,38
1.2662732702593602,1.8011961814881725,2.5745864910623224,1.0139071528457275,25,14,8,48,177,40
0.5399362794865052,1.0412814007750881,1.4594684349882052,0.32103510465930674,24,13,6,46,161,40
0.9053357355740534,1.3852703163212268,1.9674098597982304,0.5973462116038144,22,11,5,48,178,43
1.1140172156477999,1.6618099413886995,2.3421483457756542,0.8579395498610393,22,11,8,47,180,39
1.165949524107123,1.6778439217486905,2.380801117365376,0.9171144264830964,26,16,7,47,167,40
0.6975185559613926,1.1970570346112601,1.70223489179502,0.4588998811643449,27,14,7,47,147,40
0.671198067825476,1.2010861033909708,1.8109156837575928,0.42322868709180717,21,9,7,50,177,43
1.1737101743986087,1.617437439616165,2.375843110340475,0.854450174891685,24,15,8,47,184,39
1.2493662054590515,1.7822378530818523,2.632992553716072,0.9798074969901853,26,13,7,44,185,37
0.7519055159333607,1.2852103644617623,1.827342574381699,0.5352383772874809,28,14,7,42,164,35
0.6153984170829911,1.1126588628586618,1.716440994525235,0.39941628038501964,27,15,7,40,163,33
0.8460630905241581,1.3734483882102606,1.872849597993605,0.5589779872693896,28,12,7,45,183,38
1.1791722704397254,1.7220979385843802,2.433230065354304,0.8538676239150662,26,13,8,44,185,36
1.2202430152304573,1.6542726336014706,2.487824312344002,0.8927247231319538,24,13,7,46,180,39
0.5334200211668599,1.0470104624942205,1.4840248732697197,0.2624140080005347,23,11,7,43,168,36
0.3103019559703941,0.8039972569838227,1.2870608836581328,0.04457045859287756,23,10,6,44,178,38
1.1018673312694809,1.6352114015593346,2.27591894283588,0.8209029520514778,26,13,8,45,182,37
1.1038307271448442,1.6403023217155503,2.4926381448082022,0.7093529049307336,25,13,7,45,177,38
0.9327310699013701,1.439627236747971,2.2323687167331765,0.6776946256960525,23,12,7,46,168,39
0.43839301059768687,0.9266043152014327,1.48121451191725,0.16943773441416954,20,9,6,45,157,39
0.7120106986558215,1.236259534859119,1.6443078600744683,0.38850557472181446,23,13,7,43,176,36
1.1521631216643096,1.6446180985065433,2.178050233744479,0.8110796794290674,23,11,7,46,187,39
1.301157216566994,1.7580734679998633,2.593239112437155,0.936470436894189,26,13,8,51,195,43
1.1119327905099872,1.6313082759647914,2.3539572238695747,0.8306748544661382,29,15,6,43,179,37
0.6346971392359111,1.1219737509893013,1.6235492857878413,0.3913641512012904,28,13,7,43,169,36
0.6289073234286358,1.129538428900393,1.572692581566114,0.3232037037558052,28,13,7,44,182,37
0.9168670674283717,1.4313610882139087,2.1878030486423166,0.6557344284226565,27,14,6,42,190,36
0.9661628589393245,1.4465061359296392,2.2746830194667877,0.6359803044507202,24,11,7,44,189,37
0.9307427260214853,1.519231730688855,2.2588014568733663,0.6469226022169426,24,12,7,47,191,40
0.7773976781746056,1.2837258772066626,1.7006722163333912,0.508174685705666,23,12,6,47,176,41
0.3555811011147627,0.8483369823190676,1.1182247916007744,0.10077881099988395,24,12,5,49,171,44
0.9303839164733367,1.3799413365002793,1.9788607991416602,0.5575306704302415,22,10,7,52,189,45
1.1660102379882333,1.623648438525418,2.3753346174753833,0.8053590633795695,25,16,7,48,192,41
1.1790403433488523,1.7091785149660035,2.421164255404178,0.8527890732163348,29,15,7,43,197,36
1.2244720582972817,1.7553174834282919,2.6609622860779325,0.9368750461633055,27,14,7,45,180,38
0.7408813630256201,1.2581859237329738,1.8067748451542087,0.4493238716583723,23,12,6,45,168,39
0.4094375927356362,0.9440030430633369,1.4164519518516214,0.21996893854953525,21,11,7,45,160,38
0.6277939963950389,1.1480131765256152,1.674373756194851,0.31019381708421256,25,14,7,47,170,40
1.10549251943591,1.5573667749162718,2.1587025105725752,0.7195011424759834,23,12,7,45,188,38
1.2368839083006564,1.7518373998357888,2.533963102793275,0.8810362414867976,24,13,7,43,190,36
1.222994534173618,1.7743922727335835,2.6861319344275563,0.9382011601842767,26,13,7,42,179,35
0.869341822251932,1.4034252255512478,2.0615122458387454,0.6180821087874703,26,14,7,47,168,40
0.421217625421378,0.8924812826474473,1.404411149387906,0.13637839117851325,27,12,6,44,174,38
0.8579377959891118,1.335862231545648,1.8712433992075983,0.5362731293878369,27,15,6,45,171,39
1.1953476783015624,1.6993980737121692,2.4260812043450235,0.8555707528000456,23,10,8,52,186,44
1.2605570705887246,1.8174575222922624,2.5813560265400763,0.9550037173256275,25,14,7,48,187,41
0.9436532585506023,1.4619208311633916,2.1732112310667504,0.6419988293920265,30,16,7,44,169,37
0.5491463548986264,1.0937827397930382,1.6088938673002513,0.28431893833753585,29,16,7,46,167,39
0.7652596777484405,1.2811173455656983,1.819679259361496,0.46131918954419926,29,15,7,43,167,36
1.1584140787204236,1.6524638384547785,2.3554836232284946,0.8018561391651358,30,14,8,47,179,39
1.100552853808209,1.6666701396663086,2.3860718337513562,0.8196845506031788,31,15,7,43,178,36
1.2478663822383482,1.7808742927501817,2.5495346015985696,0.9081007048883247,28,15,6,43,175,37
0.6654766472869036,1.2274459508120033,1.8331825442247007,0.40633309172196264,24,12,7,44,162,37
0.5326413737639553,1.0299171767901445,1.3917103633379435,0.22194820928790793,24,12,6,45,155,39
0.6075353431403459,1.0829300531249748,1.6317296893250428,0.2535678450165625,26,11,7,44,163,37
0.9029861538851355,1.4279826528288406,1.971430039715056,0.5742613729886358,26,12,7,43,178,36
1.1646142172695009,1.7159616683157315,2.2169125028729635,0.885227911682714,26,12,7,43,179,36
1.0185711440394993,1.5033600672435785,2.1419136865625417,0.6919207822658661,25,14,6,42,162,36
0.5789372809622377,1.1673395455072981,1.5610984125714005,0.31323092440239364,25,13,6,45,161,39
0.3439273618217681,0.8703711829551244,1.4300038436080436,0.13789044392137056,25,10,7,46,160,39
0.7430036041395729,1.253078065897968,1.7433266834541201,0.5101193070231376,25,13,7,43,166,36
0.9408561489812084,1.4590485748629043,2.0343521010433494,0.6471596748268534,27,12,6,48,180,42
1.1213840821075964,1.6917120918511004,2.330018376922742,0.826384051342561,29,14,8,45,176,37
0.979709666479716,1.502106090608849,2.1944005631375356,0.7012640875758829,22,11,7,41,164,34
0.5564480800084188,1.0720588331340462,1.633221010650645,0.3196875235330852,26,13,6,46,162,40
0.49766453326507254,1.0236740267340925,1.3608685695071299,0.23230638465243064,27,15,6,45,155,39
0.9736905383230839,1.5019021936848274,2.2113775069751123,0.6573753327435556,26,12,7,44,167,37
0.9785408327146651,1.4533190244681253,2.162785111862088,0.6346866119767985,24,13,8,43,176,35
1.1732320715523374,1.7281296761576836,2.378657226812793,0.8806147953438836,22,13,7,43,164,36
0.679888885207171,1.1816625323318684,1.7567746554925243,0.4233664287074469,22,12,7,45,153,38
0.5783546580150054,1.1138931591123242,1.4196999396657737,0.3533101060852545,26,14,6,44,147,38
0.5965242238384165,1.1581842202787227,1.724437190597357,0.32774226075081136,27,15,7,44,173,37
1.1059083258518267,1.625653221812673,2.221942030058507,0.8143477739970303,28,17,7,46,181,39
0.8696738674131231,1.5126427548109012,2.0451262393300604,0.6829700091709423,23,13,7,45,171,38
1.2228382369400552,1.4832703943654466,1.9245948502054897,0.5772413653832676,19,12,6,46,157,40
-0.4002263351968784,0.7214720491302571,1.354813605847414,0.3106025189728144,22,9,6,44,139,38
-1.130040883588469,0.5714573302266672,1.3446215714221148,1.618152600816006,37,7,6,42,157,36
1.0066899329732275,1.7379716314089912,2.402238064433446,0.982329417046993,25,12,7,23,174,16
1.221912710872921,1.8509930157177072,2.460190397082486,1.284375824424768,28,16,7,47,169,40
0.89336623023518,1.3911199796590894,2.2942133052414055,0.34478824940369346,27,15,7,43,161,36
0.5527210313249504,1.0930748512115405,1.5881779382502612,0.3356920364090522,27,15,6,45,141,39
0.5827683256906656,1.0809017219081507,1.601396360650181,0.35138391934454627,26,13,7,46,156,39
0.892649984208695,1.3235519785759837,1.963480963035168,0.5807267195537975,22,13,7,50,170,43
1.0869488708415942,1.5688982721792852,2.2484090024570857,0.7689440911944961,26,16,7,48,162,41
0.9945802119477365,1.5469701985833941,2.204317314912264,0.7288556394941953,23,11,7,48,168,41
0.9660550012460064,1.4653904986908515,2.084988499743726,0.729879329104697,23,15,7,49,152,42
0.5408362652342313,1.054561818989722,1.5293575009159786,0.34621626857621124,22,11,7,49,145,42
0.5361038263478444,1.0406092201461439,1.3885733827441364,0.3795922521401994,26,15,6,43,155,37
0.9530898954758704,1.4791183559017813,2.0428212061944144,0.6997506277622416,24,14,6,42,166,36
1.0992266663408443,1.631762679854543,2.233006308320385,0.8582265864974747,23,12,7,43,167,36
0.7809926767039889,1.3063242126773742,2.008024743515645,0.519572086691743,23,11,7,42,166,35
1.1450063702474784,1.62252135594205,2.110909053223633,0.8416928297472233,24,15,6,42,152,36
0.6256855111704323,1.1404969021066562,1.6384221507596504,0.4126612419129421,24,12,7,40,135,33
0.3376901303839022,0.8648730796507369,1.180825072998974,0.1826573956850051,21,11,6,43,131,37
0.3732094091931812,0.9511628742511695,1.4024202929395153,0.06832626458399638,23,12,7,46,160,39
0.7166446701103963,1.251222666048843,1.9495132154525152,0.5951923253101163,23,12,7,44,152,37
1.152418354395093,1.7048021395267776,2.3733533816440073,0.9121295734907728,27,15,7,44,139,37
0.9700747433659629,1.563771354449749,2.289629264073493,0.8012003048773555,25,13,7,46,137,39
0.659242066867423,1.245202510181166,1.7401678528180096,0.5803540712083103,25,14,6,47,140,41
0.6408082358767904,1.202297712806461,1.7506788053816187,0.5193141647032526,23,14,6,34,130,28
0.612869423783358,1.0617153351589348,1.5305868926450112,0.4833244651467386,27,14,6,41,130,35
0.6054712027776858,1.1366958095320936,1.544371004881865,0.4603847793499837,23,12,6,42,157,36
0.9301513104390358,1.4704040768240239,1.9464136015842608,0.6935449559305216,28,16,7,45,173,38
0.9059236813551755,1.3872410233109174,2.026168526382955,0.6025230720625083,26,13,7,44,181,37
1.035784161833293,1.5050625458978044,2.178197461988613,0.7538982563452139,24,13,7,44,186,37
0.8884567755206645,1.4066776864629285,2.1028360288429666,0.6966878446559664,25,14,6,45,177,39
0.538775405523981,0.9947416359113962,1.4982790247345805,0.2822026991763187,24,12,6,47,150,41
0.35039154084952406,0.9246150442976242,1.325228006392836,0.18816758880118106,24,13,6,42,151,36
0.5942697122790106,1.0922996977900008,1.57106000960842,0.3797712192559285,24,12,6,43,166,37
0.8953267552758257,1.3821199366529175,2.0312488667564272,0.5896472750774859,25,13,7,45,177,38
0.8627762482069008,1.475276994024161,2.1067196481598884,0.6307131450192385,26,13,6,44,179,38
0.8794177527152153,1.4805475303929487,1.9851785226954253,0.6493834231662456,23,13,7,42,184,35
0.9941332054014319,1.5357088990249887,2.1863928768010266,0.8112507893990293,23,12,6,42,165,36
0.44706458976780344,1.0017980100168031,1.4817874150487649,0.27547148886801875,22,10,6,45,147,39
0.45226917823951834,0.9918124349964806,1.354924333853165,0.2514520363829656,25,13,6,40,147,34
0.5812402759905975,1.1011548106009803,1.6769154548903384,0.3732702551251749,26,14,6,44,165,38
0.9076939970633152,1.3694106525960037,2.0577198580206333,0.6373753462956409,26,13,7,43,177,36
0.9513722650625132,1.4091235685008467,2.0626156223451804,0.650988782291008,22,12,6,46,183,40
1.0197150051214898,1.5527981437337504,2.2300813899476846,0.7634084177874734,24,14,6,43,169,37
0.5275137459279808,1.0180566940145228,1.5456264474492423,0.3104482896716919,24,13,5,40,147,35
0.3542984394935421,0.8714824999429539,1.3802963047173908,0.17594307486847477,25,13,6,44,153,38
0.6936290922783821,1.1926223692325408,1.7071311110919436,0.44697302352664325,26,14,7,43,176,36
0.9014753957286505,1.3659706212592777,1.9931245637253867,0.5977603788609301,23,12,7,40,182,33
0.9761996375142652,1.4989038883799415,2.1404727168988997,0.6856230009212121,24,12,7,43,177,36
0.9172570804708267,1.420342464567594,2.172615236072744,0.6886801455235444,23,11,6,45,182,39
0.8242149326735083,1.2991523113484515,1.9708839380242156,0.6034792514946452,24,12,7,44,152,37
0.4745095058605528,0.9539267462472363,1.5146814296741495,0.26959738734019656,21,12,6,45,143,39
0.5589005986395265,1.0822633998671451,1.562911307456095,0.40386249877562064,24,12,7,40,161,33
1.0342364581964334,1.4992524385996124,2.1252623635645804,0.7651656795488795,26,14,7,42,174,35
1.0028633184127085,1.5250564336181904,2.1838956789452753,0.732909554305603,26,14,6,38,175,32
1.133916904794738,1.5708376169713854,2.251998322209441,0.838026924192419,24,13,7,45,171,38
0.7831021478490816,1.3075520903366624,2.0068723676346027,0.5555587061472481,23,12,6,45,156,39
0.5322607171247808,1.0317741126990958,1.6292042473710833,0.3446192132697333,25,14,6,41,136,35
0.4289292736810252,0.9962895969863904,1.471740372558907,0.31343962751596177,28,15,6,40,137,34
0.6179417568588578,1.1479080894914264,1.7309105859460068,0.3733143875355013,30,16,7,46,158,39
1.1028135063011422,1.5720978789943199,2.2584130323295244,0.8049838285830762,25,15,7,47,169,40
1.0172582305495996,1.570345300590033,2.2723841842240207,0.7734132227556529,24,12,7,47,174,40
1.0785654732517942,1.628048295471948,2.3227373138737475,0.79236711876486,27,14,7,46,172,39
0.6882255321415931,1.279433577520956,1.8867510628374056,0.5727463484330677,26,13,7,45,165,38
0.5650840358143019,1.0485349474800707,1.630815480714202,0.31324242348745257,29,16,6,47,144,41
0.7415406534840566,1.1527702250162275,1.666241755504583,0.5121102438722924,23,15,7,45,151,38
0.8602653444657687,1.3605898634356,1.986561264923675,0.6601522735015222,24,12,8,50,164,42
1.1025355479388155,1.5951459776524723,2.277984661954565,0.8034635469045286,23,13,7,50,171,43
1.1561974520085747,1.626120042053624,2.315511943576145,0.8308611282047826,22,12,7,50,177,43
1.0626171480914983,1.5974036354928733,2.299016874083131,0.7884043715171539,25,15,7,50,154,43
0.6800929046910138,1.216761041361203,1.8043220015415065,0.5112050413463505,22,12,7,49,144,42
0.5422065313321991,1.0105546883345902,1.433417856390101,0.35513701114894447,22,11,7,46,140,39
0.4900831388150041,0.9295269597886675,1.4347158484622775,0.1711971327098898,25,14,6,43,160,37
0.9610930606402138,1.4566346204667298,2.075123550195717,0.6969032424907751,24,13,7,45,170,38
0.9650021360877561,1.4498052339216307,2.0128568194375593,0.6689084438627313,24,13,6,42,176,36
0.8492340052375098,1.3734826450625865,2.1213768103427757,0.5807508755606847,24,13,6,44,176,38
1.0444597512506417,1.5314409096571788,2.1337423449509507,0.8394867669988466,24,13,6,41,166,35
0.7764256204150295,1.287874440200393,1.7581077875447553,0.5526837910478514,23,13,6,46,149,40
0.4392883292438594,0.9178418372751636,1.3439303137281922,0.24966986299724359,24,12,6,41,140,35
0.4543130811950029,0.9701726881876913,1.4081623757093018,0.25770836966398175,22,12,6,41,152,35
0.6838459909081889,1.2549948334269527,1.8673332194712016,0.48561019446869186,23,13,7,45,170,38
0.9119427932576738,1.3817663186792877,1.9482553946940895,0.6530820613290573,24,14,6,42,168,36
0.9847961718351259,1.33574515385269,1.8657791542203888,0.7356309319753909,22,10,7,43,166,36
0.7488278993359998,1.1607870825789681,1.6239153002453954,0.5042103077587804,25,10,7,41,143,34
0.3695942006141819,0.919737780222719,1.2823155496872924,0.3091739757847035,23,13,7,44,144,37
0.3564722858943867,0.8562233918945845,1.1171217661807458,0.17875394628296482,28,15,6,44,167,38
0.5486072245961815,1.0145498007123253,1.3271437413390386,0.36871111995697287,27,15,6,46,181,40
0.6831272500436449,1.1425962215087575,1.6037259175481684,0.44665158401383775,28,14,7,43,171,36
0.46330281066250834,0.9641997746744837,1.5162757482568572,0.27056462212617427,25,14,6,43,164,37
0.6819167180036132,1.1490728619920132,1.5543403359483823,0.45730850924163974,30,11,7,46,147,39
0.3634739141121144,0.843148869015512,1.2804792643071572,0.41746848931465913,28,14,8,32,142,24
0.5536332721406193,0.8362044443789528,1.3069359480055063,0.3759932669927722,21,14,7,46,153,39
0.5529785432899543,1.0503187819415292,1.7103748480669982,0.5940117332554203,19,10,7,50,168,43
0.870552048745158,1.2660215143135893,1.8760363113198844,0.5983043021043362,23,12,7,49,162,42
0.45039305883281844,0.9572393237438728,1.5948166316360681,0.24830021510717948,21,10,6,49,160,43
0.6454617432151641,1.0892991012321929,1.715227156245426,0.23367385639606142,23,13,6,39,141,33
0.3185897087554921,0.857064203610616,1.0599073596126,0.02016798578862805,24,12,5,39,139,34
0.39263626559297604,0.9067257316589474,1.2541294391610647,0.25477875634831904,23,12,6,43,151,37
0.6278929658639645,1.1424911249942822,1.5387682394605195,0.4130596869081682,24,11,7,38,152,31
0.6092132924454698,1.136201193149555,1.5887017264812684,0.4619716808592371,27,14,7,46,155,39
0.990392284287335,1.6161635263013006,2.2907025862576056,0.9015529913223428,25,13,7,45,145,38
1.1802175572374212,1.7569420275680514,2.5577817888181564,1.060102882049153,26,15,7,42,144,35
0.9885483058277493,1.5920435111394373,2.3015577296148595,0.8869913527469011,24,15,7,46,139,39
0.5359041533051083,1.1438923160354948,1.8265637699406256,0.558692807517242,23,11,6,41,129,35
0.3427988666909549,0.839661604518114,1.2809158974510426,0.28934852790740173,22,10,6,39,127,33
0.4012034467201579,0.915950814361019,1.3730277119942986,0.33879677159153,21,12,7,40,126,33
0.5267152059166601,1.0110734752998953,1.5363607032009554,0.44863265346636594,27,16,7,41,133,34
0.7264928183276866,1.2229742481925163,1.7671292367004274,0.5638004615811595,23,13,8,48,152,40
0.6576770054518278,1.142502028080065,1.6092125671969104,0.4303952999852864,25,13,6,42,159,36
0.7033092840592695,1.2213020200424578,1.7895445007918285,0.526972757397096,23,13,7,46,161,39
0.8320748286983598,1.287998283179638,1.78498859791251,0.5274591899090866,23,12,7,43,161,36
0.49533251424927777,0.972785179837954,1.5019266427711946,0.42844307736282583,23,12,7,45,151,38
0.21776662007773517,0.7520364472140616,1.1707814558058698,0.09199530809411771,26,14,6,38,141,32
0.34881067861143233,0.8132443597338221,1.1697121749688852,0.2575270137239105,22,10,6,41,149,35
0.6992320235958611,1.158819452915965,1.7295169581769372,0.45024166469485744,26,11,7,41,163,34
0.5525343583054648,1.0344471586428883,1.5280268523360343,0.2891533482489884,22,12,7,42,167,35
0.8365558303776799,1.3909137777276954,1.9066858002407465,0.6564508423615907,22,11,7,39,158,32
0.8880406355124393,1.3881148017509701,1.8654976865320503,0.6516611949995943,25,14,7,40,146,33
0.5880720668825267,1.136672095877884,1.6624576587015327,0.26743042191633737,27,12,6,40,135,34
0.5110126283983636,1.0284883567560197,1.5610508826651275,0.41121541251331856,23,15,7,44,131,37
0.3043858301841572,0.849757465665829,0.9863638411671083,0.17261933651837608,22,12,6,46,132,40
0.5558033294455043,1.048018240231487,1.4952713421257762,0.4346652076036522,22,10,6,37,135,31
0.851923166823626,1.2900770294118413,1.79738950311078,0.6097559073705884,24,10,7,41,146,34
0.327085219808222,0.8333821442981331,1.4904191251056322,0.10054558172490113,24,12,6,44,154,38
0.7632950830594563,1.2857222693141268,1.7976190252196096,0.5111270017859659,23,12,6,42,157,36
0.5030386762406617,1.0436366214260278,1.7105436818226831,0.3687864024155296,24,13,7,47,153,40
0.47071877675645685,1.0790179840014908,1.5691220493639806,0.36786332919253306,27,14,6,41,129,35
0.5341762184859892,0.9800878050598465,1.5778898955749976,0.4914635314634544,20,10,7,47,133,40
0.45014354091133885,1.005705616487264,1.3416947610100762,0.3247673172429707,23,14,7,42,138,35
0.5790705656676205,1.0517476256573985,1.4310911122057268,0.373791733886657,26,14,6,43,143,37
0.576059721455835,1.083383509269841,1.6594054742231976,0.3482033911742375,22,11,7,47,152,40
0.7888350830974111,1.287007587272979,1.7875022447922886,0.5928500250563125,25,12,6,43,156,37
0.9358402609553902,1.5062263805316871,2.060716001329433,0.7650368737481021,25,12,7,44,157,37
0.6278977837594788,1.0810942723916914,1.601721837781445,0.5395203016350585,22,12,7,42,142,35
0.4785548946750704,0.9335667715404141,1.5151050659925434,0.5379639997594361,26,16,7,43,130,36
0.08828949960168503,0.6514173977023048,1.0522990199261457,0.10051622559671175,20,8,6,46,137,40
0.8981393559449953,1.400193337268161,1.9000105222797499,0.7969120289969778,24,14,6,41,138,35
0.5386429524556062,1.0467080265868558,1.5166202551306625,0.402684724074575,23,11,6,43,145,37
0.8258139925190606,1.304817884463308,1.8327920686113344,0.6161775485545202,22,12,7,37,150,30
0.871973677456281,1.4094789156092864,1.9722866520214288,0.7039622853192455,26,12,6,39,143,33
0.7988015320731461,1.3473771739536553,1.9735562010283263,0.6679688832141985,27,15,7,41,128,34
0.7634357459661935,1.302446675780721,2.0631605159887414,0.7195813884487615,21,13,6,51,137,45
0.6652114040791249,1.229017085175433,1.8993463166991684,0.6022457056230861,22,10,6,37,130,31
0.4748493943274377,1.0364384778816569,1.6474803785500072,0.4113827245118296,24,14,6,39,126,33
0.36618704920624817,0.90540957416737,1.3321865319131991,0.306606152642957,24,12,7,45,120,38
0.38572901061629,0.8714042398182484,1.2831314375694733,0.23799892771346876,23,15,7,44,129,37
0.34454335883158765,0.7549224413864861,1.2467993701417504,0.17534499745410875,25,15,6,38,145,32
0.6396769694264112,1.218940782035752,1.8216801493567853,0.5783407410893953,23,12,7,41,149,34
0.7490844514692521,1.2259739741207583,1.7745703003910651,0.5593420976441699,22,12,6,39,148,33
0.811470086939024,1.2962190220112522,1.7818888025722854,0.6680849407793344,22,12,6,43,155,37
0.8520491303841194,1.3159168353667363,1.9325045989383072,0.645486979622338,21,12,6,40,157,34
0.6845985792594403,1.208627518861563,1.7452479427886654,0.6022580565937725,23,13,6,38,147,32
0.5096075578510623,0.9920412829077025,1.4901822482408145,0.4627186923631383,26,17,6,41,129,35
0.500270999800992,1.045355633881989,1.4384526452230557,0.4245089241533834,24,16,7,43,132,36
0.32403957028952646,0.8669386678564485,1.3453972852766523,0.2844757746148224,20,12,6,40,141,34
0.6422300946126696,1.1265901263546307,1.6546142168690934,0.518174365178236,23,12,6,37,161,31
0.9023272788016493,1.438638778952695,2.06756465407579,0.729566762962613,26,15,7,44,169,37
0.9320811749905722,1.4312188265427777,2.0189046954839927,0.6783072082096517,21,12,7,42,167,35
0.9504620141014481,1.4525537051380064,2.0853863367783174,0.792530850206467,25,14,6,37,162,31
0.731682222476388,1.2579251970237293,1.8093680575035247,0.5501064131416199,24,14,6,41,143,35
0.4925765071777496,1.0616078273470562,1.5145423728121419,0.4356528065125568,22,12,7,41,135,34
0.4099810817077864,0.9233534643148044,1.3532301207224018,0.328874731345561,26,16,6,34,83,28
0.0395249237339092,1.1712022315270105,0.8420325471233627,0.6012626255544369,49,26,6,50,190,44
0.4846026589760888,1.07463254654242,1.9269659962560066,0.5167659418740075,21,9,6,47,144,41
0.8715419773404322,1.4515753883961133,2.2233971508747548,0.7384785866418131,22,11,7,41,158,34
0.7990537540903853,1.3765079097940696,2.2150812004939304,0.6194794616911175,22,11,6,42,155,36
0.7034009723351214,1.2484508383779649,1.9081079061627249,0.5425905003431428,23,12,6,35,136,29
0.5020861371104708,1.0732674711748098,1.5089611014126894,0.3841239838424674,24,13,7,41,134,34
0.545891835935961,1.0488847830466692,1.5220569907859713,0.3853711226495561,25,12,6,38,139,32
0.7340591776561372,1.2173417402413569,1.811769994817089,0.5660116653208294,26,14,7,43,149,36
0.9561083362077469,1.502604789849071,2.1675961273182613,0.7370406413878617,26,13,8,48,168,40
1.2189362547642204,1.7601460504725772,2.526475874318292,0.9986919595435696,29,17,7,42,163,35
1.249631419816081,1.7865753007442582,2.5835402374517673,1.036346737030225,25,14,7,45,170,38
0.9273056260076225,1.4795917896949606,2.135249517570367,0.760917404879063,25,13,7,47,155,40
0.5474062244190092,1.076783050166962,1.5604334490521445,0.34709530960638374,25,14,7,46,146,39
0.4570067118185157,0.9183496734988393,1.1677116338093558,0.2736549546811534,26,14,5,42,138,37
0.7672373733632012,1.2772899675361824,1.7016114158752993,0.5429067690260789,23,13,6,43,155,37
0.8485617118529705,1.3256118905428391,1.8386926510297408,0.6740936017259965,22,12,7,38,167,31
0.9259304209462775,1.3916537054444404,2.06393428256597,0.6605110990335217,22,12,6,41,170,35
1.0562980257847407,1.5125237980860187,2.1057426352328323,0.8124072115658147,22,9,7,43,160,36
0.7019631275843417,1.1929100308745821,1.6689364237446143,0.5184396323035682,22,12,6,44,143,38
0.22272235419795694,0.7431210703025292,1.2650008124467713,0.2229634122497426,22,13,6,42,136,36
0.2867311286493037,0.8074998460814655,1.279165308862936,0.2728131493899706,25,13,6,36,141,30
0.6330314712793107,1.131482394040988,1.7462198790975105,0.5279972274197505,25,15,6,40,149,34
1.0040452227090635,1.4866045738546145,2.0194798590589516,0.779253803279973,26,14,7,45,162,38
0.9853224738613797,1.4877754587903569,2.1348476142981845,0.7115563239822994,24,15,8,45,174,37
1.0411791166779465,1.519989529282459,2.2215413070535917,0.8413516376724853,27,15,7,41,156,34
0.7895458674071871,1.2967827161517806,1.9003618961298816,0.6453534785707778,28,15,7,44,139,37
0.42341106269078843,0.9460081824022557,1.4511152070286057,0.29289636551041365,23,12,7,46,136,39
0.3097141332509161,0.8398851054700955,1.13149203014354,0.2191359021572057,23,12,6,36,132,30
0.5060154571755685,0.9766151781878847,1.2524707895858465,0.3292399898094754,26,14,6,38,137,32
0.7746120572050732,1.347261355010037,1.8577999403517396,0.65353533791433,23,12,7,40,150,33
0.879526245024187,1.4602613026579758,2.1230876795926648,0.7138681135968303,27,14,7,43,155,36
1.1975307510566797,1.8127904740299572,2.4444796949389693,1.0767230432566612,28,14,6,43,157,37
0.8799651278503122,1.397148383195261,2.0050055157986497,0.6851720312329939,29,15,7,45,139,38
0.5292096842787612,1.0554311930815192,1.645537842344579,0.414590030472306,23,14,7,45,131,38
0.3550759606313453,0.8492778135785242,1.2950473025875915,0.22446046143684495,19,7,7,43,140,36
0.6117631954000862,1.129430050442572,1.6007082269454396,0.47159541867474203,24,13,7,39,148,32
0.683028834381677,1.2562944305800028,1.7730910034819516,0.5590276700241241,24,14,7,41,150,34
0.8577100365252249,1.406382364602554,1.9057597223532239,0.6759148836663493,23,13,6,44,155,38
0.8496773458171019,1.3725546480619473,1.904066597555775,0.6786677307875193,25,14,6,40,151,34
0.6006767570419802,1.0673492739658197,1.5587419520262604,0.4334404942443244,25,15,7,39,130,32
0.5014388794724387,1.1301023403114359,1.6012477679167734,0.3292769958812023,44,15,6,42,137,36
0.3015816110250261,0.8062087907048525,1.1790879845821989,0.07082366838285054,25,15,5,37,145,32
0.6520299378979889,1.1975260620182109,1.7616246564545897,0.4479767364717304,25,11,7,40,146,33
0.7119642093609895,1.2451630576739878,1.8565585493009633,0.5424775021907646,23,11,6,40,146,34
0.8442708089372497,1.3703267764029716,1.9232748733471283,0.6788409730946288,23,10,7,44,154,37
0.70253117555409,1.2228427389932643,1.837734665421433,0.5783529585056917,22,10,6,43,162,37
0.8599065108614954,1.3407146097711726,1.9353923456194855,0.7062458542806744,22,12,6,39,139,33
0.4715210808942458,0.9782171131297344,1.586417442067809,0.4909065002893473,26,12,6,43,133,37
0.880234411812607,1.4168261256206411,2.019372753101793,0.8785456193964322,26,13,7,39,135,32
0.6471573650569485,1.1641941218000091,1.8625972546773801,0.5845933804186378,19,11,6,45,133,39
0.4464031570954107,1.2668800527487032,1.8083427472004758,0.5471195748987746,23,11,6,40,133,34
0.6159568057767895,1.4242838334097385,1.9790922508897548,0.649923143295869,23,13,7,40,127,33
0.8379674387256804,1.4034676290217925,2.036829948222688,0.7049888371204478,26,14,7,40,124,33
0.9430611374881652,1.44378653207559,2.120625504217532,0.7995349628766725,24,14,7,41,132,34
0.6643258208220939,1.2079682909473566,1.4583457352626195,0.5846687338982821,21,11,6,39,141,33
0.6613018452315698,1.194568331352475,1.8926699277354417,0.6008613100357187,25,12,6,32,141,26
0.5923587536338539,1.2628604109214328,1.7390832684148227,0.7534621597240558,22,12,6,43,137,37
0.4696828525316685,1.0383763474487162,1.3043771294583921,0.4899722415210407,29,13,6,27,124,21
0.6846287320464837,1.0661421921771015,1.261728282756656,0.4291349722393404,26,16,7,39,133,32
0.8296739717253079,1.3728294260708964,1.9445577708125512,0.723420847166639,22,11,7,46,147,39
0.8432663392094262,1.36887155367482,1.9850787621853032,0.6202247776173577,22,12,6,37,155,31
0.7466108765828252,1.2504717862370134,2.044572010683673,0.7144488590039627,22,12,6,32,163,26
0.721179219895097,1.5614734128180667,1.8469112712476465,0.5692079066976892,23,11,6,42,163,36
0.29730674181388894,1.0841537842376778,1.6991554585346844,0.03869506269761591,27,10,6,41,145,35
0.7015240150608341,1.4601770314673603,1.5618958529460931,0.8274218996899284,49,12,6,41,142,35
1.1112393220256296,1.5809476859623854,1.4738725434937185,0.35433709821629555,22,13,6,41,143,35
0.8842484078943035,1.4251572275490938,1.8989928950168196,0.6627436918366587,26,14,7,39,143,32
0.8037561189469322,1.3882988626342812,2.002836729423393,0.5489463351492443,26,13,6,43,145,37
0.6400316067740278,1.1615103192688983,1.715284208103749,0.45970943150665794,23,13,6,47,136,41
0.3337896169251765,0.7797971283521371,1.2487738414144216,0.16079093213985818,23,11,6,39,142,33
0.24886990344405702,1.3707989370536962,1.69745203191844,0.3566212398517602,25,10,7,42,149,35
0.7681832537230489,1.3176589777609826,2.032243841409995,0.616848382036718,24,13,6,43,147,37
1.2746758615707445,1.8507713778658434,2.6697187614635145,1.0036087522601838,24,13,6,43,154,37
0.9869127417203355,1.4953753679307444,2.1432510127971427,0.6962118734978131,22,12,7,43,146,36
0.5108168403066975,1.03927279035516,1.5150315015302904,0.3564638512593058,25,13,7,40,132,33
0.5720895985824824,1.0851783021014345,1.6208451021402324,0.39659918017811624,25,15,7,45,146,38
0.7209576403262142,1.2547249139288772,1.9083975330008127,0.6532044288833934,23,11,7,49,165,42
0.7688323611700015,1.2943636120159947,1.7532031002463397,0.4815650848422033,24,13,6,47,170,41
0.8246322824701423,1.2740261279296812,1.6760088112875127,0.6109797190036818,21,10,6,45,166,39
0.5743020113002437,0.9886316106413354,1.3648932872743214,0.2943817806177775,22,11,6,49,167,43
0.7114794881441762,1.2598227495997179,1.8453582191728224,0.5356663320996413,23,11,6,49,167,43
0.7726977171333942,1.2869437094893796,1.9268895736479048,0.6164786453065243,24,13,6,48,164,42
0.6892548247398429,1.223779600519449,1.9351541279473128,0.5263950938341673,24,12,7,45,162,38
0.8799689068036332,1.4432084450485885,2.0616667747769144,0.7012731632501236,25,13,7,42,150,35
0.4455347039793317,0.9518421125542997,1.4748835065579107,0.33893990283249487,24,12,6,40,138,34
0.3182832313383039,0.8623549017187657,1.3448635997487182,0.2503875383005123,25,12,6,41,135,35
0.5779918509462199,1.0657373456431398,1.3876652190908998,0.37395809103408145,28,16,6,38,138,32
0.9121841750005629,1.41582574466526,2.0318529285683264,0.7161471182649342,29,16,7,45,154,38
1.0904381262272826,1.5643152844874406,2.217924089609622,0.7714528728228319,23,13,8,47,165,39
1.0786806049881545,1.5525424604889504,2.261337610205414,0.7782322578604952,24,16,7,48,169,41
1.091816677914793,1.612355631061907,2.2037441305642327,0.7986394749903153,26,16,7,46,168,39
0.9505137954839193,1.441418188551256,2.00684852748447,0.7027174294963645,26,15,7,48,155,41
0.518462213355857,1.0260852216277672,1.5565058110792402,0.342580266421405,24,15,7,47,152,40
0.7358424551457383,1.2174076631398427,1.7510384688723415,0.6354324337787582,23,11,7,48,156,41
0.6076294613284274,1.213104454062537,1.7220351996810535,0.48065537263503433,24,12,7,44,161,37
1.0912923981971048,2.0989847241305597,2.125083941624622,0.2512562125964102,25,14,5,21,143,16
1.0453120567871415,1.5530374327153214,2.1839855531395367,0.9241135741425116,23,12,6,36,139,30
0.6087407531416098,1.2572638641421132,1.9225047036663443,0.5110533427337802,25,13,6,43,138,37
1.415504843710052,1.769005616842687,2.3151256802771765,1.1473006197755558,24,15,7,41,121,34
1.097766224328788,1.5738178754520817,2.24470702113305,0.6564589732221064,26,17,6,42,130,36
1.0350272326489076,1.4956582228296997,1.9991358750753956,0.7877129222687909,24,14,7,40,125,33
0.7566644731036021,1.1823789688237667,1.3531839521273077,0.4625804288705086,23,14,6,36,122,30
0.4247226268145129,1.0666780114842362,1.2421154120255182,0.06623323979493778,29,16,6,25,126,19
0.6030269664485903,1.2871787847738538,1.844706739967874,0.7101355848104205,45,17,7,44,136,37
0.5753678139788486,1.0762916338318682,1.614383360168918,0.35506446367155475,23,12,6,45,153,39
0.9179101420274485,1.4443213387935492,2.072338569827222,0.8005059478209955,21,13,7,41,155,34
0.9427994814107675,1.4079675990394531,2.048565617254183,0.7445257006829784,22,13,6,43,154,37
0.746369861872176,1.09315655326103,1.6302483239222125,0.7822888206008737,22,12,6,37,141,31
0.3482541770106652,0.9882308561607483,1.5439127432831206,0.2898805385580862,36,12,6,42,135,36
0.5902487148158742,1.0793481507064726,1.5716144293831678,0.3982838834243151,23,13,7,41,143,34
0.7467675883416275,1.2990524388046099,1.8910963349925018,0.5334704595359743,27,15,7,43,153,36
1.1152815230780275,1.581116148008317,2.245455335625185,0.8397731819261585,25,16,7,44,168,37
1.0764086221274076,1.6548217771994822,2.258637498204041,0.8147148307506269,28,15,8,45,163,37
0.8137450104865183,1.3539897249752049,1.819542802402901,0.532548593058279,28,16,6,45,146,39
0.6111945247563277,1.1435728378806453,1.6592102164793114,0.45776476952611667,22,12,7,49,145,42
0.5049615937355976,0.962646233035078,1.5253570902013915,0.31831369434317774,23,11,6,44,147,38
1.0760884682078165,1.4833331250493247,2.158906118551471,0.7389247074537957,23,12,7,46,170,39
0.998499517660358,1.538186613318775,2.088751712165914,0.8051046374656743,23,12,7,41,167,34
0.9009844531380213,1.4180269582401328,2.1149905720151607,0.5705795197995247,24,12,7,44,167,37
0.7845429443641101,1.3204195418750024,2.0423100679278643,0.5698194349486827,23,11,6,44,166,38
0.9539468000569051,1.4927137683339922,2.0459777242845014,0.7523848631565232,24,12,7,43,164,36
0.7875164317613328,1.349774793345428,2.02496772915332,0.6403912756238064,24,13,6,45,157,39
0.5668485825408573,1.0294887721173052,1.4427036885657905,0.3254000019487278,24,11,6,42,148,36
0.5704637990447537,0.9996345279756528,1.5879582928679734,0.4432010017680504,25,13,6,39,144,33
0.778349125397005,1.2676517740222164,1.9362723991234334,0.5968403068265774,23,13,7,43,150,36
0.937411224821511,1.4884862126427187,1.960734220003683,0.7902525658388411,22,13,6,43,164,37
1.0451818759951201,1.5749813446265286,2.2143465192764626,0.7686612455676303,27,13,7,41,159,34
0.7772060379563305,1.2789481299773708,1.87269533080544,0.5111629110587059,24,12,6,42,152,36
0.5328105547508795,1.0501093537062833,1.616220219385335,0.3600844535023022,26,13,6,42,152,36
0.5159956965445278,1.057753402709041,1.7122552141010774,0.6321472957781027,28,14,6,43,146,37
0.9296555152642143,1.4134412269935488,2.164705238507308,0.5864688445508309,28,16,7,45,151,38
1.0872534968475607,1.6477997688098731,2.321752646667973,0.7763324281538562,26,16,7,47,161,40
1.0233553486189553,1.5476147986712192,1.9608323526786655,0.844457961402813,25,14,6,42,149,36
1.179226071924761,1.7097764159117015,2.4001376306476834,0.9695057375435059,20,9,7,48,163,41
0.5279067496978342,1.1708360708477763,1.9209915163961129,0.4219192426280466,22,11,7,52,159,45
0.7488869952418998,1.0916080396805588,1.3950378752375605,0.4381377242477784,23,12,6,44,152,38
0.6828228176304934,1.1684374202924217,1.6207508136077684,0.5339711320017357,26,15,6,43,154,37
1.364049290761243,1.8246202430705802,2.5158705484342274,1.1594012513468817,25,13,8,40,162,32
0.9112834230763169,1.451559169442488,2.136953087958823,0.7372148426263788,25,12,7,40,164,33
0.9667470715224578,1.4634601258809667,2.1178599940197302,0.7299274232447654,25,13,6,42,167,36
0.8467500818846647,1.4194583697071828,2.0126878756454216,0.5542745151166437,23,12,6,39,162,33
0.7538014907280173,1.2720809092639411,1.917882691324627,0.6250310870448434,25,13,6,45,156,39
0.6264402942860271,1.1217812929691635,1.514072446000167,0.5163372371346224,26,14,7,44,146,37
0.524861767668227,1.0183694874200713,1.5589012774517796,0.2535478830497081,23,12,6,42,153,36
1.097023636772115,1.5349610422177373,2.102142704270533,0.8485108846958933,22,12,7,42,170,35
0.9716657549822298,1.527910932164555,2.1388674164776447,0.6402083676131326,27,14,6,43,168,37
0.9215580620130044,1.4185116741295807,2.015437908131586,0.7473734804617492,24,13,6,41,164,35
0.5328538018597002,1.0154436164478264,1.5164540452841595,0.3975802733052828,27,13,6,44,161,38
0.7041217467190336,1.1593654918064868,1.7040119326488912,0.5293214281891787,27,13,7,43,164,36
0.7421045852525912,1.3175232661796126,2.0506074047645706,0.603806864591378,28,13,6,43,171,37
1.0693532989452748,1.6018404060773217,2.161683894717762,0.8919648928124484,26,14,7,44,175,37
0.7854256842123183,1.3380617370601067,1.9853841806744341,0.5566707222502117,25,13,7,41,168,34
0.7162112510897227,1.2393246517772478,1.6690059236738755,0.5900288089715559,25,12,6,39,157,33
0.4361271134303529,0.9169574773162874,1.3799107163341555,0.27484160310273553,23,12,7,44,148,37
0.6159397690486225,1.1687770013320449,1.7273019207470672,0.44386682450967585,26,13,6,41,151,35
1.153952334993866,1.655819938304054,2.1724922093227432,1.0192715580902796,27,14,7,40,154,33
1.2792565647768797,1.7063797024952354,2.2806767669977033,0.8046956603507327,23,15,8,46,165,38
0.7454361175951417,1.320942649480462,1.9689369384052018,0.6993585354966375,27,15,6,44,166,38
0.8347659459743757,1.4425072823189478,2.24805473529294,0.8027357179756822,28,14,7,47,148,40
0.688240746177806,1.172861203594617,1.7213334436881478,0.5347238185509156,24,15,7,45,140,38
0.20680020076249395,0.737407366192161,1.0910429613210897,0.023515867987194794,21,11,6,47,154,41
0.941607134486632,1.2949807055211422,2.1976295949437676,0.7169243163850251,24,13,7,46,167,39
0.9166851374296592,1.4243851701707904,2.1342478198451524,0.7332299803312939,41,12,6,43,169,37
0.9515953193848279,1.4258697196792358,2.0722271860742376,0.6661406769182394,25,14,6,44,161,38
0.2139976545909037,0.9712715275689275,1.5332832404987544,0.0649949648213558,24,11,6,40,147,34
0.5952804896869276,1.1553729751276478,1.522261976546369,0.39685609839065417,25,15,6,36,137,30
0.030655762965711847,0.9901479667733084,0.8743022143354979,0.248023005243099,47,10,5,43,150,38
0.5218925824733552,1.3177804274818348,1.4821649098946905,0.30390494953118735,28,10,6,47,150,41
1.005882144257963,1.549575920401629,2.0500137766650006,0.8983481980932712,26,15,7,44,153,37
0.9696240648558654,1.5486310093836215,2.226182139563405,0.8400356408594791,27,15,7,44,156,37
0.9309826945531553,1.492753944017279,2.1937064757028235,0.8403300393165256,27,16,7,47,154,40
0.855284859350281,1.2363547428796844,1.7264930695675222,0.746056613062426,23,12,7,45,143,38
0.6114212193013646,1.0445092182757505,1.524100772409908,0.4161441733342309,24,13,7,29,143,22
0.6609258998320551,1.1619165516865209,1.7071124711884842,0.6029863176154424,24,13,7,22,149,15
1.090260093159511,1.5435684027264907,2.2723360639886923,0.8904226972911063,25,14,7,46,157,39
0.7841431188058487,1.2716784121551927,1.932027960138269,0.7288561672606235,24,13,6,40,148,34
0.9027037170708164,1.40656209082986,2.0708466441922617,0.8109161158101315,22,10,6,27,136,21
0.8255848487716392,1.423832890814376,2.196597690733849,0.6660436100737545,28,15,7,40,135,33
0.6076616818038574,1.2871246091151187,1.974377735468805,0.6405728874708917,24,14,7,47,127,40
0.6602929271772561,1.3258653032949304,1.9150210045140266,0.6582180021753102,38,13,7,38,129,31
0.7269731796718253,1.4210930864639493,2.056926601658951,0.8490531164692632,24,13,6,38,123,32
0.33007054115625556,0.9046535818260066,1.2659668763531768,0.33192701885885245,24,13,7,41,118,34
0.44349232071266553,0.9499484260485571,1.4725627418451528,0.37938680771778893,23,12,7,44,131,37
0.42729396268932496,0.9485809920416165,1.4840071145888731,0.37118232677471524,23,12,6,40,143,34
0.8560559298402711,1.3624772178019458,1.9544717154111961,0.7482893731548597,23,12,7,39,153,32
0.8055096249005853,1.3381065035744266,1.9264061764040306,0.7028535917253278,22,12,6,40,159,34
0.8752904186707462,1.3938104624094667,1.8027464014362158,0.7034602364366014,24,12,7,39,157,32
0.6108208365327877,1.133358312131062,1.7361118699094709,0.4984812951389558,23,13,6,39,143,33
0.5443404871788313,1.0165381506488265,1.4781659893338448,0.3705934350646565,27,14,6,39,137,33
0.4262578473384747,1.1559621726134692,1.6026147026946682,0.352657654088509,46,14,7,44,142,37
0.9420922421781149,1.4345186730650434,2.0831207492222963,0.8523522470375705,19,9,8,46,148,38
0.9031422185242479,1.368415913702127,1.9244209838948743,0.6386475798813869,24,12,7,48,159,41
0.8914432215241326,1.372329547769008,2.0224888902719815,0.8190547768818932,24,14,7,44,156,37
1.034354084508498,1.5544469203616536,2.102709069734593,0.7878224147799657,23,13,7,41,155,34
0.8664955473321093,1.454236861706918,2.073647906459583,0.7365949288427032,22,12,7,39,155,32
0.6324444934793064,1.157612458277778,1.8709215351552952,0.3754118535201161,20,11,6,40,152,34
0.691061070629329,1.217808788185751,1.8446207036924958,0.5292788886206133,22,11,6,40,141,34
0.41210264026832116,0.9022394682928963,1.508569580493473,0.3032769522842202,22,12,5,40,156,35
0.7672961614014219,1.2665055930361484,1.9968991293853529,0.6985741522672491,24,13,7,43,155,36
0.8152809887030692,1.3539302766335937,2.0038237505560073,0.5834035776696993,22,11,6,40,152,34
0.8596436238510314,1.393969471446587,1.9668846567031304,0.753473586609784,25,14,7,42,138,35
0.6171607458299084,0.9804811333141255,1.6972373007944603,0.371599052583796,24,14,8,48,152,40
0.9439714828687777,1.4641915171862059,2.1300624919117754,0.7637830658075847,21,12,7,46,154,39
0.7276822707609885,1.2199504798505882,1.9916123548195495,0.6583755858973748,21,13,6,40,157,34
0.7778953802530801,1.2857544354147947,1.8933556964459664,0.5803240442260043,24,11,6,44,145,38
0.49216442938690663,1.0725806674545924,1.4005086378314697,0.4112617274374745,22,13,7,37,133,30
0.559520928789139,1.1304276934483917,1.399852377296149,0.33544706001001845,41,14,6,40,142,34
0.7746409531546258,1.239884568207807,1.9491867785331003,0.5851987033526815,24,12,6,40,153,34
1.1172047623094927,1.6336971338059283,2.2247689599462346,0.8087169932210381,27,15,8,42,159,34
1.02304003459936,1.4861067493346616,2.2748366946732688,0.8163093531013363,27,16,7,42,143,35
0.7209410476260092,1.1940053584945152,1.7571984250516128,0.5233948011224565,26,16,7,45,131,38
0.2254683197296165,0.7185132254246225,1.2456616008528156,0.09582747759015908,21,10,5,46,140,41
0.5852490290068019,1.1006020984220208,1.6384682461587188,0.4447683913749221,23,13,6,42,143,36
0.9267352823788846,1.4774304513734444,2.127669855597562,0.7816787218006657,23,13,7,43,150,36
1.0294120488389837,1.4486592460136034,2.1317662050848543,0.8278696353757686,22,12,6,41,159,35
0.6814639967511827,1.1996815306003843,1.8301979827490462,0.5634640059176927,24,13,7,41,143,34
0.42181389749911985,1.0311884328829977,1.52681901441249,0.39714743452038204,25,13,6,38,145,32
0.898866537417338,1.4197032744000628,1.9729410518763428,0.7612830611611079,29,16,7,41,149,34
-0.061289769645635594,0.8800337116410606,1.8846412704568873,0.3327776145972553,27,8,6,45,159,39
0.974000987885285,1.548607204492336,2.185881199875333,0.606300980419205,26,17,7,48,157,41
1.0423159399523532,1.4190870482086533,2.1247725711226138,0.8521101252044065,20,11,7,50,145,43
0.8272379632283425,1.066350764160482,1.5732627884697221,0.6113951565717234,24,14,6,44,145,38
0.9360542848897004,1.4237514320144553,2.046608470161646,0.7726729596290459,24,10,7,40,146,33
0.9679343346197306,1.5118864340744034,2.1142984491061663,0.7864199118771307,24,12,7,44,140,37
0.5363623729678622,1.0887893653877296,1.8447322482325113,0.4191748107573877,21,11,6,41,139,35
0.7631930075299268,1.341228421144854,1.9757651804466172,0.6516946108942365,28,14,7,41,122,34
0.9345859003479263,1.465960019020126,2.118238175203661,0.8234228323176926,23,16,7,45,129,38
0.7372745755303728,1.299321977547451,1.8624285507554323,0.6489474885750994,21,12,6,40,127,34
0.606561597097024,1.1270521299315153,2.0062071451250767,0.7615946146326673,22,14,7,40,125,33
0.5578465799607778,1.0580948931261707,1.4646246556630442,0.5093087491269996,28,15,6,35,116,29
0.8411224117388982,1.1954559777170695,1.7239787239189743,0.7383138096516343,26,16,7,44,125,37
0.6723713745340701,1.1675422207448967,1.7407304621736253,0.5647512887457747,24,14,6,39,131,33
0.8750776734278383,1.405838813688972,2.0007984611123324,0.7478084569729888,24,15,6,40,136,34
0.8926799367548139,1.5202558289017447,2.104057351430092,0.9624156508273527,24,13,7,36,131,29
0.8278038835854619,1.3104114030544256,1.9619911199744366,0.7187176396561334,24,13,6,40,125,34
0.5411236859080838,1.038903208209703,1.2770852580604255,0.3301820797556896,24,15,6,40,130,34
-0.5151282892142384,1.2428191133796536,1.355998244567489,0.9878330518480876,21,8,6,39,137,33
0.7350384028249113,1.3241087482337568,1.9496088154444065,0.6381531790184817,35,11,7,41,134,34
0.618163475139754,1.2393145485912282,1.9408497906398687,0.6176421883886478,24,13,6,43,129,37
0.7279437270083935,1.1970372529319921,1.8520362842274034,0.7044834330353892,25,13,6,36,117,30
0.300579968490553,0.8027833444808389,1.0203305870503332,0.26220876173067453,23,8,7,44,133,37
0.8655407060789752,1.3663176375279895,1.9445616926433296,0.6598967975653356,21,12,7,40,142,33
0.7660174320763549,1.4123455048681657,1.9836806243142646,0.7804743035082287,25,11,7,39,149,32
0.5403513607536549,1.094868775342193,1.6477029210589342,0.4591610158076902,24,14,6,39,136,33
0.4383552647981071,0.9613046833431419,1.237539949240074,0.33013981355311733,26,13,6,41,142,35
0.8997502182517654,1.3482543487323795,2.0892502409773073,0.8002915064018614,29,15,7,40,142,33
0.8110642765921542,1.4004731487567876,1.9879050417578128,0.8043976908506526,23,13,7,48,147,41
0.815320331582631,1.3898689825562502,1.9071186313210298,0.5067506938836797,22,11,6,44,151,38
0.7992938912157432,1.3061094545127432,1.717769124435208,0.611431302525282,22,13,7,35,135,28
0.44492031061679116,0.984760166943839,1.4040647534548434,0.3725634161327716,21,13,7,42,149,35
0.7301132702764979,1.3934315668037909,2.003388939606019,0.7005153099985489,23,13,6,38,149,32
0.8729360632901141,1.488793951276618,1.9408047282219374,0.6846695497945776,27,15,7,41,148,34
1.0186773998103467,1.508998163262049,2.0196935787111783,0.770564598540475,27,15,7,39,139,32
0.7217298993628586,1.3577539122050877,2.0284540876282353,0.6722407849007374,25,13,6,42,135,36
0.9341231067959109,1.4759709222315378,1.7904156670599165,1.065176067899644,19,9,7,46,135,39
0.873457915663843,1.4862482443737732,2.0622108435217834,0.8058585641202843,23,13,6,39,129,33
0.8606040366003032,1.4346697535218236,2.091158369463387,0.8077334886929524,24,14,6,40,128,34
1.1260518605736873,1.5553887565697944,1.8234063586585854,1.323290736770507,27,14,6,11,121,5
1.4697599966844201,1.2887138199936763,2.1894213465652514,0.8384107098245588,42,13,7,45,126,38
0.7080132959070891,1.2252560576288853,1.5413127870784946,0.45898516737546613,25,13,7,25,121,18
0.7513030423477943,1.2340820803740267,1.5240332693477723,0.6247460511592529,22,14,7,35,133,28
0.8636127850305211,1.3878041465024087,2.0230368197832704,0.6310333847452156,25,14,7,42,138,35
0.8063500841680762,1.3716371727196883,2.1253371834549135,0.5821896343508519,26,10,7,44,152,37
1.078226636864499,1.4862298488547365,2.208695676582944,0.7874600815909018,21,14,7,47,145,40
0.6878113201494358,1.1989814624309458,1.8736908576859725,0.675657857896955,18,10,7,42,144,35
0.6074551224618233,1.0238885126168311,1.2988065233492843,0.4821981583134946,24,14,7,41,142,34
0.9012618136196161,1.4541039232229216,2.0279865099034153,0.5821481744268542,20,10,7,41,141,34
0.7611891014164595,1.3156084753964,1.7380925147638626,0.39296287312689127,24,12,6,42,149,36
0.7222430425186201,1.2505963605741233,1.8736658986840173,0.6273852746016699,21,11,7,42,154,35
0.8270021305999523,1.3584996000150502,1.9494195189115195,0.6140945101192873,23,13,6,40,157,34
0.9751134062905484,1.5139447701344735,1.9773583213963155,0.7982792561333328,27,15,7,39,146,32
0.606214894260109,1.1118740429098954,1.7246278606373902,0.3822950819810354,33,13,6,40,128,34
0.3982413842307891,0.8686942342127277,1.3790892417834673,0.2363391973392197,21,9,6,46,138,40
0.5564270313895355,1.0335887001131392,1.5727359379426837,0.27191665139889676,48,12,6,38,135,32
0.7873879478054018,1.3604241458977517,2.1920246066909375,0.3691538918591407,44,12,7,42,144,35
0.9190630828397769,1.322434061583603,1.8822982328152351,0.4354230228097853,24,12,6,39,159,33
0.903943713765943,1.3799785570706318,1.8575747827388218,0.570956889402539,25,14,6,43,166,37
0.9499939839026171,1.490306109307117,2.0261305804213325,0.6748858991465572,26,15,7,42,164,35
0.8407699918785345,1.3403543950018575,2.0004606615928804,0.6302847337077491,25,12,7,45,174,38
0.49084507134655,0.9552070032126627,1.6418102191603952,0.29805235401868785,25,11,7,43,162,36
0.539989159746986,1.0463752403361122,1.2681404604427429,0.3722034798952112,27,14,6,41,154,35
0.34043604634039315,0.8553135765872895,1.3018044077141988,0.1456836634376305,27,13,6,44,151,38
0.9253559586167537,1.4698928880848505,2.059197892446306,0.7144182389972182,28,15,7,44,147,37
1.178774730643902,1.6987656546721517,2.516389001501298,0.8851100852334604,25,16,6,45,147,39
0.7033632709237797,1.1618228503143881,1.8045960966850676,0.29527869142302143,21,11,6,47,140,41
0.42000503081707863,1.0841080274458736,1.6302435237387884,0.2792289580323667,25,13,6,29,133,23
-0.3345746813896224,0.4521893458156145,1.3715025725474392,0.8935169373218166,25,11,7,46,135,39
0.7204745853200822,1.182760859143785,1.576613762944123,0.5303876433103624,24,12,7,40,134,33
0.8740124542091512,1.3587213857197722,1.8030547471009555,0.5856486178777711,29,17,7,43,143,36
0.9723215684050989,1.4334906681328206,2.0630206808063845,0.8273462867482557,23,12,7,45,152,38
0.9584198227300665,1.4939843274008802,2.1211235821936216,0.7993291137220186,23,11,7,46,155,39
0.5697226066157252,0.9926674144739696,1.506289029925498,0.4484614004113284,21,13,7,41,135,34
0.3750853020092457,0.8685746209693659,1.2637859453960045,0.2054978782146772,23,12,6,42,135,36
0.5651931183857237,1.0830351887438814,1.5512167762040132,0.4036363573732483,23,14,7,40,141,33
0.7537964406772882,1.2150566716418052,1.810859203182746,0.549029455741036,25,15,7,43,142,36
1.0304536588367186,1.5098260362983331,2.138516017188311,0.8472415732375451,29,16,7,40,147,33
1.0605421248475406,1.6017579798675872,2.312310915004863,0.8667237664777668,25,14,7,45,141,38
0.5653899111850784,1.06762773998501,1.6996363997279522,0.3962550654634523,23,11,6,48,139,42
0.4423891951783479,0.8855870372251935,1.3545448781127325,0.2901305761248041,23,12,6,37,137,31
0.6370160609384726,1.1609695191868927,1.7072351210684396,0.4702023114966684,24,14,6,40,149,34
0.7553523753196276,1.3045308643968747,1.9070521660238735,0.5099699432937588,23,13,6,42,161,36
0.9439717901541674,1.472567392970463,1.9305182513589672,0.7449250242279603,26,13,6,41,153,35
0.6565579650035215,1.1873500771736052,1.708143868533766,0.5189947693278768,22,13,7,38,141,31
0.5396996654810515,1.0847909324647946,1.5920645873084345,0.43638590979784,26,15,6,42,135,36
0.5265592514152077,1.0197198979916045,1.4273737248642133,0.40607456560435556,25,14,6,41,138,35
0.8306410123839268,1.2859311561949,1.7966491038328312,0.5869073676459082,22,13,6,41,146,35
0.8531937551925883,1.370170443111565,2.0081557150659135,0.609778002042219,25,12,7,41,155,34
0.39151932343867213,0.9497621559938029,1.6332704122465793,0.2466397231647086,23,12,7,41,164,34
0.9830166542562132,1.5282179165554235,2.0043850125202187,0.6901707887960992,23,13,6,40,158,34
0.763584576291476,1.2909970348114759,1.82486369977943,0.5654450161102451,22,12,7,41,160,34
0.8374860101191733,1.382261821977294,1.890654806741202,0.626201985731694,23,12,6,42,162,36
0.5614061276236681,1.147987833152141,1.4854217121003135,0.4115974698845425,24,12,6,40,138,34
0.399748264089964,0.9515894160925988,1.357075585390222,0.2680762498394056,22,13,6,40,142,34
0.8556118655747207,1.349444328385155,1.9750343907919923,0.7241397223530011,25,13,7,41,142,34
0.979136072548082,1.4760863705531904,2.111647214581316,0.781912356349106,28,13,7,44,146,37
1.0096313780674784,1.456834983680063,2.1621618476091014,0.7688836990362877,22,13,7,47,152,40
0.4753007181225691,1.031591235080834,1.6953658525344157,0.18818121885694394,20,10,6,45,156,39
0.7593808761671357,1.2894546825574078,1.8008324943903753,0.5419826070263973,23,11,6,38,144,32
0.5436631568237139,1.043134974330302,1.5013326036143049,0.3719294482924582,23,13,6,43,149,37
0.7081108311087277,1.1735080382277348,1.7598370861284356,0.5404764599367515,28,15,7,43,152,36
0.9142617395087189,1.4281477495167663,2.035471022541131,0.6418454736425916,23,11,7,45,161,38
0.7741700033227883,1.3363101121696035,1.9635278967000542,0.5877506406146302,24,13,7,44,160,37
0.8087403843142296,1.3520966719014786,1.924038934583833,0.6046445726331281,25,13,6,43,145,37
0.48976337949713133,1.039761334284795,1.5062628939668885,0.3215794435103404,28,15,6,40,157,34
0.9146670507612111,1.375004800789956,2.000986705203839,0.7021933663153593,26,15,7,41,160,34
0.9347987088720857,1.4683290563728713,2.0304724503001,0.7543708511975858,27,15,8,44,154,36
1.0477434052317074,1.5594874558289356,2.1422415648314854,0.8111246104978931,28,15,7,45,158,38
1.0323500777581964,1.5085481907371014,2.0894599607912463,0.7774313583999712,26,15,7,46,156,39
0.867082033785974,1.488424129163909,2.2208923796162656,0.7395356867033822,25,14,7,46,149,39
0.6017383003289745,1.163226198505541,1.5002030991351494,0.4329966677047582,22,12,6,44,137,38
0.36234749981011033,0.8504008144563903,1.226222315375019,0.22464452711505878,23,9,7,39,133,32
0.5299743498399616,0.9928220949483855,1.4066185481685736,0.3290818315328444,45,13,7,41,144,34
0.948503375588152,1.4308255594689605,1.928553111611697,0.7878515533399979,26,13,6,40,146,34
0.8226116925371851,1.3007250898180458,1.9655482179821289,0.5734657716919893,24,12,7,44,148,37
0.9921097304130935,1.5121636687633493,2.1059189742896955,0.7022200618125636,30,18,7,43,153,36
0.7355394179145265,1.396509543589957,2.056083819463882,0.8447956195932455,25,15,7,45,145,38
0.41567051464932914,1.246815463252981,1.8491056379506143,0.5121582071172697,39,10,7,47,138,40
0.36230823106409804,0.8458837568336357,1.3662604541934495,0.29970127606984714,22,12,7,36,130,29
0.517396756463926,0.9533786609684319,1.4815879843362327,0.3386201520937744,22,12,6,43,140,37
0.8496425628734875,1.3987049075730573,1.8912995151886531,0.6306515750733335,25,12,7,39,136,32
0.9702225584927813,1.5674700028148947,2.178573162869427,0.727142570253446,28,18,7,41,136,34
1.109829982550981,1.656222824662394,2.392746915659049,0.9343425318902757,25,17,7,43,140,36
0.7443455610126242,1.2698906545302309,1.5612594879959079,0.5478145174197697,24,13,6,41,134,35
0.7340023003036029,1.1768207281899876,2.009681156663322,0.7064364019936773,22,12,7,27,131,20
0.8704945442969425,1.3113398456502567,1.8873856067043941,0.6280549707764185,38,15,6,41,137,35
0.7766529002653065,1.3976395327898743,1.9996629537894925,0.8186006686726093,25,13,7,39,133,32
0.5307332499754036,1.1649774845888294,1.755621018354768,0.5646825594935305,26,15,6,44,128,38
0.40387205270058396,0.9348104254993906,1.2330370640877866,0.2949456870106868,23,13,6,40,135,34
0.5911976248439218,1.1020712884796122,1.642393240263905,0.48299075630187716,27,14,6,41,142,35
0.5879798271471842,1.0206695446268759,1.6103751815832759,0.46219935093436015,23,11,7,40,144,33
0.6544827034846766,1.1988599309227745,1.757817019257677,0.4664727768200916,28,14,6,39,143,33
0.8847743714025729,1.420348670095501,2.052446232655958,0.7394320682578466,27,14,7,42,150,35
0.8497431564700769,1.3970991032437179,1.9143020841003398,0.7652569638089204,27,15,7,40,132,33
0.22224780649586456,0.6508958721717691,1.1655472025548625,0.08309572763406553,22,10,5,42,142,37
0.7558692546424814,1.2546296458324482,1.651432359922743,0.5584170540888473,23,12,7,38,153,31
0.9504214532438287,1.4801759770696556,2.1287169739603944,0.7028428216849214,24,14,7,42,153,35
0.8691283322761735,1.4024997057687232,1.8379853550708645,0.6010082834750307,25,14,6,42,153,36
0.7496362116873745,1.31734871157938,1.904751340502926,0.6992308156379716,23,12,7,39,153,32
0.501423635477471,1.0357331948806625,1.586431344439125,0.3877987507735566,26,12,5,39,136,34
0.6940970549232883,1.132029113527009,1.5610135297424832,0.4085700356885592,26,14,7,41,130,34
0.8515180358923646,1.3538812827244582,1.8965019892055694,0.7170659159033389,47,14,7,41,142,34
1.0032260837382847,1.4748687261258642,1.8483303446692538,0.7119597414061203,21,11,7,44,155,37
0.7266892996634298,1.285826567817043,1.7708617362759784,0.4886917353631059,23,13,6,44,164,38
0.7719745900367372,1.3490799361144985,2.026748179268282,0.5765561903409562,24,14,7,43,164,36
0.8048052907538411,1.2507178031704427,1.690526820285812,0.5734048156348273,20,11,6,41,151,35
0.5028230278158635,1.0194214981293528,1.6379603834629468,0.3178945586840603,23,11,6,38,136,32
0.5117469686328986,0.9991426368813379,1.4106929084381061,0.3317791219976877,22,12,7,44,148,37
0.5848504291121123,1.0503006990601613,1.5336741321844423,0.3478090692569326,27,11,6,43,164,37
0.9851461409537227,1.4803149173684984,2.077625604296233,0.7421979996921474,27,14,6,41,173,35
0.9883196515033648,1.4905730944078275,2.181524084727491,0.7277655243809936,24,13,6,41,174,35
0.8570686484545701,1.3275840380225137,1.9708626542327727,0.7387181871172402,24,11,6,39,168,33
0.9006052623230466,1.4863744165458712,1.95038979643035,0.6375272588819735,23,12,6,42,163,36
0.7835746938112539,1.2470003643802408,1.7460291129169958,0.5947512109335946,24,12,6,45,155,39
0.669187685387685,1.091891558041496,1.4338668267898675,0.45591780511776603,24,11,6,38,142,32
0.4931401619091436,1.00889823782747,1.4804707274781743,0.3406627260583466,29,15,7,44,148,37
1.0227881850481264,1.5027478128950928,2.180749479495353,0.6879921317646671,27,15,8,47,146,39
1.067943736196491,1.4407877553191546,2.168457607978498,0.7777759755918682,21,11,8,49,161,41
0.9381043105609119,1.48676167609969,2.1373231669959742,0.7301678165809289,20,8,6,49,162,43
0.8387670545205148,1.3951838623040371,1.8920153543104166,0.6452991638799291,23,12,7,44,155,37
0.8009488301084418,1.2793789653264522,2.011125836553779,0.6091516265299645,22,13,6,40,157,34
0.8652097003515481,1.4302880884734313,1.9696420969371284,0.7129012919862809,24,11,6,44,158,38
0.8637256274879012,1.361410519162757,1.9066703556790237,0.7029912023827243,24,12,7,41,146,34
0.4821475954153676,1.0383190705491632,1.4548539634510362,0.3486686859425001,24,12,7,43,134,36
0.5750103336762387,1.0890533875847306,1.5143595130105953,0.5256884171106542,23,12,6,42,134,36
0.8380003442035131,1.35409009754691,1.8851101049493886,0.6660436110280195,27,14,7,43,145,36
1.0339740708907241,1.574825207471672,2.217635960878108,0.8738555879506263,28,16,7,45,150,38
1.0939194491356965,1.5708569973196689,2.2623986612938545,0.7839958005982799,22,14,7,47,161,40
1.076766844998028,1.520004723299462,2.3002968769517866,0.8855639531690056,22,12,8,44,158,36
0.5675272392213214,1.132698490387921,1.7425687574960702,0.4231429118833534,25,11,7,47,158,40
0.46553646607830046,1.0003939654600111,1.3962917222460822,0.2202681788374059,23,11,6,43,152,37
0.7714403200183291,1.1111958403346636,1.9917270337051443,0.4645942250787046,22,10,7,44,158,37
0.9172923925402618,1.478907620106018,2.0472363385253223,0.7274924173348081,25,14,7,41,158,34
0.9909521910267209,1.4934486465026664,2.0726304395195614,0.7724034095368411,27,12,7,38,160,31
0.7353092857036869,1.25992180782202,1.7811987460588088,0.5843159417501695,24,13,6,39,160,33
0.8660371532954557,1.3949521267496847,2.1005345362780528,0.7659247935847153,25,11,6,42,159,36
0.917712288579949,1.4887122448249106,1.9764873513548955,0.7468976276070712,25,12,7,41,158,34
0.782843350023857,1.3636846390030615,1.9451862230357078,0.6350164296783686,23,12,6,41,154,35
0.5505765745816122,1.1079397931723307,1.3870796789138138,0.5055118624843165,27,13,7,39,138,32
0.4104981618620227,0.8078551674433174,1.179651923925134,0.19540617338667382,29,14,6,41,128,35
0.6838708586541506,1.2017572475870584,1.7213703565242477,0.5063096606723976,24,15,6,47,142,41
0.9168260638641103,1.488914601007848,2.1173913281838823,0.7310996584908261,22,13,7,42,146,35
1.3654956334395227,1.8018452968036955,1.9771386436548521,0.53368215128646,23,14,7,42,157,35
0.8739751408098656,1.358112116919829,2.1923196785989187,0.6500140045709705,24,13,7,28,147,21
0.9146586219906145,1.4453108434395818,1.5198661164859757,0.7220674761117205,23,13,6,41,136,35
0.4048854570634459,0.9954531931895947,1.4251546929842354,0.17945159410125694,22,11,6,38,147,32
0.7334538657815328,1.2796775384878933,1.8170361259338585,0.679449443755871,26,12,6,34,143,28
0.9979466205205276,1.4003054267041921,2.1414997603040353,0.8394708213268083,27,15,7,45,157,38
0.7760695029528841,1.3839679742363105,1.9214053892167813,0.5143642743129695,24,12,7,48,164,41
0.956981890820554,1.3628182792098888,2.184778022324758,0.7361383250262502,24,16,6,45,162,39
0.848079386615068,1.3413576824654045,1.9793531309491783,0.6742401814775448,23,13,7,48,161,41
1.0694753704994764,1.6453715858051285,2.6014293302619214,0.8345216238418709,23,10,6,49,149,43
0.8670648431839474,1.3989259082011298,2.050067829472349,0.702563279365122,25,14,6,44,141,38
0.8435810586969303,1.3432454617230134,1.9045845272876831,0.6945458228660123,23,14,6,39,131,33
0.809628123420984,1.367227282502517,2.070900927247971,0.7531818167226308,22,13,7,41,128,34
0.5089164312700019,1.050688386095624,1.6442202368505763,0.36258413846793075,26,15,7,40,125,33
0.8583410181694483,1.3294439209611004,1.8697429554053584,0.6259062612575637,22,13,7,46,130,39
0.9718002935006649,1.5029857512458153,2.2419680568128735,0.7993869896720496,23,12,6,41,130,35
0.8560554138780248,1.4082665953726323,2.0889923016265968,0.6702838567982505,27,14,7,40,125,33
0.9202847492754032,1.4268408527255256,2.053606624198533,0.7253464950636809,27,17,6,41,116,35
0.9696347287276239,1.5125529646556053,2.2366011590789707,0.8432220547553215,19,9,7,42,130,35
0.5224494130895418,1.171119807186122,1.8150538227662154,0.46496991261894915,23,13,6,37,131,31
0.37584238256205343,1.171803899891279,2.022929866548994,0.4157695541882823,23,11,7,33,127,26
0.20131605845557776,0.9061469603385212,1.0542466526854537,0.21507309013731568,43,13,6,29,119,23
0.45180222273848253,1.2348616193415363,1.4830180022349788,0.3653342316477586,34,14,6,47,139,41
0.6268131162887803,1.157912843727145,1.7576939146384205,0.529290333174721,23,12,7,44,154,37
0.7578675875392182,1.2679255945139412,1.885349361201182,0.4663110122973978,24,15,6,42,166,36
0.8744379108464049,1.3796184914093916,1.9839348377371089,0.6015902449297534,23,13,7,38,166,31
0.8213530915204617,1.3558312506634662,1.971095555622021,0.6651447288983177,24,13,7,39,160,32
0.6351190232311855,1.134882792406155,1.6267724963317125,0.5252978165539164,22,12,6,41,154,35
0.972434561089581,1.4839609120573098,1.919283652169978,0.7835977779643009,22,12,6,38,153,32
0.8894337489021982,1.381046557933731,2.0623764712125823,0.8243551690925186,23,13,6,39,147,33
0.8152514223014333,1.3267548967182108,1.918182512792075,0.6716578618954797,23,13,7,42,147,35
1.0608601078994826,1.609576719357881,2.2563719823523165,0.8515568941339968,25,13,7,38,141,31
0.9772134276709594,1.5202991990990815,2.1946664773974796,0.8680375023837101,29,16,7,42,133,35
0.3060103758445316,0.8885565690136731,1.3228677126498636,0.20872176033048956,21,11,6,41,128,35
0.3682591805678096,0.8523034606292319,1.2409079606750102,0.31591035178310434,23,12,6,40,122,34
0.4904563429818988,1.0392656306599157,1.4312557752478465,0.39275764117308415,27,10,6,38,134,32
1.1581979252857812,1.640946968859827,2.29358079490612,0.8719681878201557,26,17,7,41,147,34
1.2255533388841504,1.682959603308525,2.4068724000240467,0.89376751105684,28,16,7,42,149,35
1.1704863773234075,1.6500876244031297,2.3781802523147118,0.9069381560371501,23,14,7,44,151,37
0.5404230931453177,1.1001066215841488,1.541191842673793,0.4239662547131004,29,15,6,43,141,37
0.7892362626491689,1.302307058226966,1.828433527627723,0.5337878984051058,23,14,7,41,161,34
1.0225384236481552,1.4471124674742355,2.132844476735838,0.7393321224553568,25,13,7,40,170,33
1.0407698703664423,1.5201020371592204,2.0770379708440467,0.6506960755437097,21,13,7,40,180,33
0.9831623765577858,1.4237879014606876,2.1458285905000656,0.7492696950694353,24,14,6,43,178,37
0.7422191004844795,1.2923127895098265,1.7926845102936368,0.6030137913695972,22,12,6,45,167,39
0.7311015711331246,1.18564314615496,1.5571928566953888,0.4965158805216343,24,12,6,41,138,35
0.5660095676066192,1.0544367680741655,1.4560844882637913,0.32733932540288563,23,13,7,42,147,35
0.6644034859691357,1.1070844992764366,1.5934195553916037,0.506933055543417,24,11,6,40,151,34
0.9284780584938181,1.456540654331793,2.160204109208764,0.6015696246664268,26,15,6,41,166,35
0.853508214081564,1.346022138136836,1.9596010278824498,0.5648058310670341,23,12,6,35,165,29
0.8379433203684452,1.354047688731437,2.107061249140048,0.7210961460793572,24,12,6,41,158,35
0.8189895283737871,1.2726989309752859,1.6832739077026506,0.575213453206519,23,12,6,38,133,32
0.4739470779196707,0.9695894869885532,1.468230764163437,0.3408265999802839,26,13,7,45,143,38
0.8084323781537874,1.3876148140499183,1.7856512514653198,0.5835648079575466,29,17,6,40,145,34
0.968771960426769,1.430028350617548,1.9545070673792835,0.7821373051827567,23,12,6,40,154,34
0.9952379396901387,1.5304203280646733,2.2581132666393646,0.8354587132395702,24,13,7,46,150,39
0.6577091337038472,1.1992773239829713,1.5854474084626764,0.4934656718983551,26,14,6,40,132,34
0.5342074168069505,1.0274872079898434,1.4667048452331883,0.3542034480886564,21,11,6,39,138,33
0.8542616354448607,1.3972420456511219,1.9424783409983206,0.6037277537337533,22,12,7,42,143,35
1.2165956996094045,1.6741925358197656,2.1749533679189756,1.0455360199754806,28,14,7,34,133,27
1.0237076296272312,1.6307615706703655,2.317003045477131,0.8933448870548468,25,11,7,43,131,36
0.8740707509695578,1.4371587385488207,2.186690459231344,0.8202366910400416,23,11,6,48,140,42
0.7083490721119285,1.333298967225411,1.901895985157976,0.626816086261429,26,15,6,42,127,36
0.8793607825393057,1.3897538284071054,1.9623160466235468,0.7522520888727089,22,13,7,44,128,37
0.7878042550065296,1.4020090023425185,1.9587734237389114,0.8174743714920113,25,13,6,38,115,32
0.8487021815761199,1.2805204245127335,1.9435095958878557,0.7328641284738378,21,12,7,45,120,38
0.567389676804591,0.9974614792131002,1.4271733530132935,0.4851231708646622,27,13,6,33,124,27
0.5991018235005636,1.015894206177594,1.5229734678810716,0.5497258458718214,23,14,7,40,131,33
0.9498207966513876,1.4590827481972406,2.1771169239207424,0.8343022037852126,26,15,7,41,139,34
1.10632365310209,1.752921306546177,2.217500843157449,0.9340530226920205,28,17,7,43,139,36
0.513612096649509,1.134830011268299,1.5229047260958142,0.48178076849646423,22,11,6,42,146,36
0.7130409648957579,1.2853786337864723,1.9495729245192883,0.5901531365006453,22,13,7,35,148,28
0.9269198761389392,1.3868436213388131,1.9835325822622536,0.8582882226892781,21,13,7,34,133,27
0.5419966239781238,1.0081719936641682,1.5641533678727593,0.4249265657533362,24,11,6,38,129,32
0.4760091820939293,1.0023773296857816,1.5701140657525101,0.41943426137910433,27,14,7,36,129,29
0.8180023902745619,1.4290102598250853,1.933611099477383,0.6527461683705958,27,16,7,44,137,37
0.48647854576887295,1.00511190576568,1.6995665919588485,0.30956520870593585,21,10,6,44,151,38
0.9679355348690419,1.5061376584621904,2.1236882686214074,0.7871995993493549,24,13,7,40,160,33
0.8011456378964079,1.281054478823659,1.816954034118544,0.5390176214774923,23,13,6,40,155,34
0.6591850239875331,1.1547277874162685,1.5194543653801262,0.4654727354889654,24,12,6,38,146,32
0.9082156524359934,1.3525984396499913,1.901562601697658,0.6948001348735924,23,14,7,42,155,35
0.9849179202009686,1.513430847341698,2.1943113165396726,0.730658791409035,24,14,7,40,144,33
0.6591921730058183,1.1844714079327328,1.8459021728417917,0.5703981332561281,24,12,7,42,136,35
0.5907475297869109,1.1266186306541048,1.6925400271171187,0.4081318519450746,27,15,7,42,133,35
0.8921297938364336,1.3784333465761698,2.006686870736008,0.7011736326510302,22,11,7,46,152,39
0.9761339658851946,1.5021397082830696,1.8800205979014606,0.7727881347667985,26,14,6,43,150,37
0.9648383334256861,1.4717568163903887,2.101359817776708,0.7471782813376106,23,13,7,42,161,35
0.8077786464216741,1.3557589316724759,1.9735557418356864,0.6235727075617351,23,12,6,41,163,35
0.7505116151563088,1.2242415816616827,1.7947255926091683,0.6143531691333316,25,14,7,40,146,33
0.4739713787370727,0.9832541538326216,1.4038913040704848,0.2806333159241065,24,13,6,39,155,33
0.8694487815845998,1.3938884487243852,1.8340583036040787,0.6542502052834194,22,12,7,40,165,33
0.8591085077308233,1.340266369611186,1.9546796558515964,0.6132864442030235,25,13,6,42,163,36
0.926219607043438,1.3631636769097515,2.0757218315724164,0.6980016164926549,22,12,7,42,169,35
0.9514248890927754,1.3703707369035747,2.0315655460064126,0.7206434607494341,24,14,7,40,148,33
0.5565022427593489,1.0704098052814668,1.5246443735033994,0.42347171751955326,24,13,6,37,137,31
0.7542929087836026,1.2666988014650016,1.7479694888373742,0.6714741154155508,25,15,7,35,152,28
1.006501903893298,1.5085094465238797,1.964007185306396,0.771075069532162,27,15,7,40,164,33
1.0321316108507674,1.5252332567349642,2.1443408340828656,0.8168318939895227,27,16,7,41,170,34
1.1876872649995582,1.7100902548579304,2.305753425159251,0.9174106937470827,30,16,7,39,169,32
1.0780626323806026,1.699578826954983,2.4390622732300002,0.8782399763938507,28,15,7,43,168,36
0.9197224290309624,1.491745547329357,2.10166036608638,0.7365824482460617,29,16,6,41,151,35
0.6545946138223209,1.1424554281718367,1.7218257034851914,0.5235645697615788,28,17,7,42,130,35
0.6916140971475657,1.204576963056733,1.726796520690074,0.4860270909941966,23,13,6,45,148,39
0.7955595712700705,1.3022538445717031,1.8375670420923989,0.5991102148194009,23,14,6,42,157,36
0.8793566358300156,1.3148779153670747,1.9055949375785468,0.6050085266213099,24,13,6,40,164,34
0.8759273111002163,1.3820980653154626,1.9709040796669526,0.6509896052264884,23,13,6,40,172,34
0.8304433192823735,1.3165707278341452,1.9585095048051904,0.6092783219685858,25,16,6,41,168,35
1.200862084176133,1.7562515007298556,2.3664786793083525,0.9366183547339096,24,13,7,44,161,37
1.1128476304434076,1.6787794814423709,2.381793164851012,0.9133841373784992,25,13,6,37,155,31
0.7928989843949673,1.4537907204249594,1.8863536490713138,0.748216335568821,26,14,6,40,133,34
0.5694038703174498,1.0720755628154754,1.4153378639572352,0.39983943645287673,24,13,6,41,127,35
0.5192090878715152,1.062935477442137,1.5189405230386108,0.4276963907091462,27,15,7,41,130,34
0.9266786262716429,1.4632554291526343,2.0577175566276367,0.7216752629105898,24,13,7,48,144,41
0.8279793094290724,1.3424486473845718,2.0146308983548606,0.5999304899357633,25,12,6,40,158,34
1.0522368717757726,1.576260578172361,2.206552964968224,0.7902752516692131,25,15,7,41,162,34
1.085765799453773,1.6003426812198165,2.064436373899115,0.8263331553396918,25,13,7,38,158,31
0.6866999657795959,1.1388175897277586,1.7538289708541988,0.47718041034295056,22,12,7,39,142,32
0.45867333319988524,0.9223170358183616,1.3799832646860404,0.2850671959856528,22,12,6,42,135,36
0.4534580035372463,0.9463681656513783,1.374306021376245,0.3136800160926896,24,14,6,38,136,32
0.7294314470494192,1.148179450964875,1.690323542669229,0.533383395362179,27,15,7,44,154,37
1.0312816377528253,1.4783076809686762,2.106231772113069,0.7364558073897668,28,16,7,45,169,38
1.0263201669323765,1.4644216917246906,2.181078832474194,0.8103231040202117,24,13,7,48,171,41
1.090266895060108,1.6086237160666719,2.2755209773755456,0.8491057636487322,26,16,8,42,165,34
1.0421216446292905,1.5680551046730373,2.2543416243720253,0.8099717638381555,28,16,7,43,155,36
1.2756592853048825,1.7927793327848744,2.419269040079893,1.0668916841075484,25,16,7,43,147,36
0.9431759822376153,1.4315514694223652,2.2730947455866746,0.8395762321104066,23,12,8,48,146,40
1.0034467707228714,1.5588240046159996,2.1773428081579587,0.8192461835342438,24,14,7,39,135,32
0.718215553748826,1.2517813352914988,1.679477188173109,0.5742442332520538,25,13,6,41,132,35
0.5998545982192743,1.1094015199826468,1.7086014653813184,0.4980459191485598,22,11,7,40,139,33
0.9949269166309471,1.4514635085934728,2.096568468119627,0.9027850214278663,27,16,7,40,150,33
1.1600803652351162,1.6056450569237857,2.306410499875234,0.8649376640396534,27,17,7,41,155,34
0.9528773119206082,1.4442595335236532,2.0179002698224595,0.7782128023050175,25,16,7,46,147,39
0.3775102074346729,0.8379844777298617,1.336316973767437,0.16929555804323337,20,10,6,47,153,41
0.59539070785832,1.0227182630078147,1.4422165096422472,0.4176494219747985,24,15,6,40,169,34
1.0033934222666137,1.4379960764727544,1.7844801911826764,0.7991733475283117,22,13,6,40,181,34
1.0728286273115668,1.4904258279917069,2.1629702051880777,0.8141290124694183,23,12,8,47,180,39
1.0621721279773986,1.550466272410212,2.0859736055724785,0.8293024190712839,24,15,7,47,179,40
0.8801369118087394,1.3820384174932783,1.9898846293196508,0.7414286554284535,27,14,7,41,162,34
1.0298621069502756,1.3834972993610548,1.50650521335204,0.4540712038116036,28,16,6,38,156,32
0.5210451427076963,0.8831125898473159,1.276629400598545,0.35436805411321526,26,15,6,42,157,36
1.0295391664782587,1.4203083459158534,1.970031757647256,0.7845796471013955,24,14,7,49,161,42
1.1872214371097547,1.5926117258344428,2.3168116035614994,0.8037618810220442,24,12,8,48,154,40
1.1133269449637284,1.572352238657904,2.2907076291397255,0.8346772596014738,26,14,7,50,152,43
0.7691519098913099,1.3206447001789308,2.153255355710739,0.5606466013812968,23,12,7,45,153,38
0.6357261135555238,1.1693278994379108,1.7413584812455358,0.46553803566819374,23,13,7,40,152,33
0.8201787506600771,1.3161742481430494,2.0448902553712673,0.6231861865169224,25,12,7,43,156,36
0.8276146966622806,1.3649432109288981,2.080831869983133,0.716108525085502,25,12,6,39,155,33
1.036727978321033,1.5783633494816551,2.1014583474005777,0.8061136202457188,24,12,7,41,165,34
0.7961543571010665,1.3371046321013667,1.8092246576246545,0.5966311241614548,23,11,6,39,152,33
0.5180050621598866,0.986084537859809,1.5454005736770777,0.3894309189044731,23,12,6,40,146,34
0.41522363766467485,0.8393305590724726,1.3332569012394972,0.21624485293000528,22,12,6,40,160,34
0.8521244523593046,1.3485454111844857,2.0751394640935796,0.6569953202512733,26,12,7,39,164,32
1.0490395883000505,1.586922730031875,2.2400717138089608,0.823563563777221,27,14,7,43,173,36
1.1107213540404925,1.579915572128975,2.277829594748657,0.893585196016618,26,11,8,42,176,34
0.8789634482842253,1.4051472237520197,2.063089759221261,0.6596414833194616,25,13,7,44,172,37
0.5634278366202661,1.036509039141774,1.424080032573869,0.3706776861480276,23,12,6,40,164,34
0.6299117869841515,1.0890474239276662,1.588035813237044,0.4242282853019684,24,13,6,44,166,38
0.689070898606567,1.3231198614226813,2.112593121923561,0.6396282680407726,24,11,7,39,162,32
1.081796269716679,1.65059561783004,2.3420239366800435,0.8857894231714707,25,12,8,44,163,36
0.7174536750700603,1.2552815830929027,1.953070122338787,0.5058682276297874,26,13,6,39,153,33
0.6776724122302555,1.233669154428634,1.7771037450181004,0.5096751844959816,28,14,7,42,149,35
0.7190934953313541,1.221433734057446,1.7471076492733064,0.5352922680197818,30,16,7,39,131,32
0.7363678662729193,1.1635580907817507,1.786505628173192,0.5001842422212422,45,15,7,45,145,38
0.672095862875248,1.1961841299244873,1.8169527007831825,0.4319270799126689,24,14,6,45,166,39
1.1150528768093932,1.627490621997016,2.323207103236017,0.8623283761649181,26,14,7,48,176,41
1.0495330997027374,1.5958409918250525,2.1368834100905514,0.800361661280687,25,15,6,44,152,38
0.780548246178826,1.4045401516543556,1.9651285358328199,0.672145654925023,23,13,6,39,134,33
0.5514437907668651,0.9800303010073973,1.532587764548849,0.3546833963093411,23,11,6,38,134,32
0.49107619360078514,1.0187809071260487,1.45800243753191,0.44104055015736987,25,14,6,38,129,32
0.8905868085592485,1.242737519386207,1.5444874996585476,0.5990154558619869,24,14,7,42,148,35
0.9062974341723725,1.4286227843526411,2.1175191679931538,0.8111136986727101,29,15,7,45,152,38
1.04771146966017,1.5664671165238184,2.1737458042065274,0.8513474827311764,26,16,7,45,157,38
0.997568425579756,1.427905993922681,2.059687425415786,0.7611047598251757,22,12,7,46,149,39
0.5510350588944464,1.043576450691909,1.5980998255503065,0.3204732186613444,23,12,6,44,155,38
